street	intersections	agencies	number_violations
10th St	n/of princeton a|w/of new dorp|w/of rose ave|e/of new dorp l|s/of new dorp l|w/of new dorp l|w/of tysens ln	T	55
1107 Goethals Rd Nor	th	S	4
1st St		T	28
2nd St	e/of amboy rd|w/of rose ave|s/of new dorp l|w/of new dorp l	T	42
3rd St	w/of burbank ave|e/of cloister p|w/of new dorp l|e/of burbank a|w/of beach ave|s/of cloister p|s/of rose ave	T	94
4th St	e/of rose ave|w/of new dorp l|w/of rose ave|w/of new dorp ln|e/of new dorp l	T	34
7th St		T	4
8TH AVE		P	4
8th St	n/of penn ave|n/of new dorp l|s/of new dorp l|w/of new dorp l|e/of new dorp l|w/of new dorp|w/of new dorp ln|e/of rose ave|s/of new dorp|e/of tysens ln	T	284
9th St	e/of new dorp l|n/of new dorp l|e/of new dorp ln|w/of new dorp l|e/of rose ave|s/of new dorp l|w/of new dorp ln|w/of new dorp|w/of rose ave	T	216
Abbott St	s/of scarboro a|n/of scarboro av|w/of scarboro a|e/of scarboro a|s/of scarboro av	T	36
Abby Pl	e/of hunter pl	T	5
Abingdon Ave	w/of genesee av|s/of lamoka ave|e/of lamoka ave	T	104
ABINGDON AVE		P	6
Acacia Ave	n/of oakdale st|s/of yetman ave	T	16
Academy Ave	n/of yetman ave|s/of yetman ave	T	13
Academy Pl	e/of page ave|w/of page ave|w/of hamilton a|s/of hamilton av|e/of hamilton a|s/of hamilton a|s/of hamilton	T	33
ACADEMY PL	wall st|wall street	P	7
Ackerman St	s/of cleveland	T	8
Acorn St	w/of debbie st	T	17
Ada Dr	n/of farragut av|w/of richmond a|s/of farragut av|w/of farragut av|e/of farragut av|w/of arlene ct	T	201
ADA DR	lenore ct	P	15
ADA DRIVE		P|S	21
Ada Pl	s/of howard ave	T	5
Adams Ave	w/of laconia ave|e/of laconia av|n/of laconia ave|e/of hylan blvd|n/of laconia av|w/of laconia av|s/of hylan blvd	T	132
Adelaide Ave		T	21
Adele St	n/of evergreen|e/of evergreen|w/of evergreen	T	15
Adlai Cir		T	4
Adrienne Pl	s/of hillside t|n/of hillside t|e/of hillside te	T	11
Agnes Pl	w/of mclaughli|n/of mclaughlin	T	16
Ainsworth Ave	n/of maybury ave|w/of shepard av|e/of maybury ct|s/of maybury av|s/of hylan blvd|e/of maybury av|s/of greencroft|e/of greencroft|w/of greencroft	T	31
Akron St	n/of christoph|e/of christophe|s/of richmond av|e/of richmond a|w/of richmond a|w/of debbie st|s/of richmond a|w/of jennifer p|e/of jennifer p|e/of debbie st|w/of saybrook s|e/of richmond|s/of debbie st|n/of saybrook st	T	67
Alaska St	e/of henderson|n/of castleton a|s/of castleton|n/of castleton|s/of castleton a	T	172
Albee Ave	e/of s railroad	T	10
Albert Ct	n/of woodcrest r|n/of rosecliff r|e/of woodcrest r	T	44
ALBERT CT		P	5
Albert St	e/of victory bl	T	7
ALBERTA AVE		P	5
Alberta Ave	e/of victory blv|w/of victory blv|s/of victory bl|dean av|w/of victory bl|e/of victory bl|s/of victory blv|n/of victory bl	T	64
Albion Pl	w/of heberton av|w/of port richmo|e/of port richm|e/of heberton av|e/of richmond a	T	146
Albourne Ave	n/of foster rd|w/of foster rd|s/of foster rd|e/of foster rd	T	74
Albright St		T	24
Alcott St	s/of bunnell ct|n/of bunnell ct	T	6
Alexander Ave	e/of heberton a|n/of woehrle ave	T	80
ALEXANDER AVE		P	6
Algonkin St		T	11
Allen Ct	w/of elizabeth	T	25
Allen Pl	n/of hylan blvd|w/of hylan blvd	T	21
Allendale Rd	e/of beverly rd	T	7
Allentown Ln	e/of arthur kil|w/of arthur kil	T	5
Allison Ave	n/of hylan blvd|w/of hylan blvd	T	53
Allison Pl		T	5
Almond St	w/of woodrow rd	T	17
Alpine Ave		T	4
Alpine Ct	e/of brookside	T	5
Alter Ave	e/of hylan blvd|n/of hylan blvd|s/of hylan blvd|w/of mason ave|n/of mason ave|w/of hylan blv|w/of hylan blvd|n/of laconia ave|w/of jefferson|s/of laconia ave|e/of mason ave	T	236
ALTER AVE		P	4
Alverson Ave	s/of correll av|s/of correll ave|s/of morris st|w/of morris st|e/of morris st	T	107
Alverson Loop		T	9
Alvine Ave		T	7
Alysia Ct	n/of bloomingda	T	12
AMADOR ST		P	11
Amador St	e/of south ave	T	129
Amber St	n/of amboy rd	T	56
AMBOY RD	fisher ave|seguine	P	18
Amboy Rd	e/of chisholm s|e/of keats st|w/of luten ave|e/of penton st|w/of chisholm s|s/of rose ln|e/of chisholm|n/of penton st|w/of sharrott a|w/of may pl|n/of e broadway|s/of chelsea st	T	504
AMBOY ROAD		S|P	5
Amelia Ct		T	32
Amherst Ave		T	49
Amity Pl	n/of forest ave|e/of amador st|n/of ludwig ln|n/of amador st|s/of ludwig ln|s/of wilcox st|s/of lisk ave|e/of forest ave|s/of forest ave|w/of amador st|e/of lisk ave|s/of amador st|w/of ludwig ln|w/of forest ave|e/of ludwig ln	T	231
Amity St	w/of lisk ave|e/of ludwig ln	T	7
Amsterdam Ave		T	53
Amsterdam Pl	w/of richmond a	T	18
Amy Ct		T	4
Anaconda St		T	15
Anderson Ave	e/of port richm|e/of pond st|w/of port richmo|e/of heberton|e/of port richmo|e/of park ave|e/of st johns av|s/of heberton av|w/of heberton a|e/of heberton a|s/of hylan blvd|e/of simonson pl|n/of heberton a|n/of heberton av|e/of hylan blvd|s/of clifton av|w/of port richm	T	158
Anderson St	n/of hylan blvd|n/of maryland a|s/of clifton ave|n/of st johns|e/of clifton av|s/of hylan blvd|n/of chestnut av|e/of maryland a|s/of lynhurst av|s/of virginia a|n/of lynhurst av|e/of hylan blvd|s/of chestnut a|n/of st johns a|w/of hylan blvd|s/of st marys av|n/of virginia a	T	62
Andes Pl		T	11
Andrea Pl	s/of cedarwood|n/of cedarwood	T	71
Andrease St		T	8
Andrews Ave	w/of richmond|s/of center st|e/of center st	T	26
Andrews St		T	51
ANDREWS ST		P	17
ANDREWS STREET		P|S	11
ANDROS AVE	davidson st|richmond terr|c/o davidson st	P	19
Andros Ave	e/of davidson st|s/of davidson st|w/of richmond te|s/of continental|e/of continenta	T	184
Androvette Ave	w/of arthur kil|w/of deisius st|w/of eylandt st|e/of amboy rd|e/of eylandt st|s/of deisius st|n/of eylandt st|e/of deisius st|w/of eylandt s|s/of jansen st|s/of eylandt s|s/of eylandt st|s/of amboy rd|s/of billiou s|n/of deisius st	T	105
Androvette St	w/of arthur kil|w/of manley st|s/of eylandt st	T	16
Ann St	w/of park ave|w/of port richmo|e/of heberton a|w/of heberton a|e/of port richmo|s/of port richm|e/of heberton av	T	97
Annadale Rd	e/of eylandt st|n/of sneden ave	T	87
ANNADALE RD		P	11
Appleby Ave		T	19
Arbutus Ave		T	14
ARBUTUS AVE	nicolosi drive	P	9
Arc Pl	w/of francine c	T	4
Arcadia Pl	e/of raymond p|e/of raymond pl	T	108
Archwood Ave	e/of downes ave|n/of bennett av|n/of downes ave|n/of bennett a	T	9
Arden Ave	s/of hampton gr|w/of dover gre|e/of forest gr|n/of forest gr|e/of dover gree|s/of nedra ln|s/of forest gr|n/of arthur kil|w/of nedra ln|e/of edgegrove|n/of hampton gr|e/of nedra ln|n/of arthur ki|e/of rolling hi	T	68
ARDEN AVE	forest green	P	11
ARDEN AVENUE		S|P	19
Ardmore Ave	s/of victory bl|e/of willowbroo	T	60
Ardsley St	n/of moore st	T	39
Area Pl	e/of lincoln st|s/of norwalk av|s/of croak ave|n/of croak ave|s/of tillman st	T	42
Arkansas Ave		T	9
Arlene Ct	n/of ada dr|s/of jules dr|e/of ada dr|n/of regis dr|w/of ada dr|s/of regis dr|s/of ada dr|w/of regis dr|n/of jules dr|w/of jules dr	T	45
ARLENE ST		P	6
Arlene St	s/of victory blv|s/of dawson cir|s/of amsterdam	T	76
ARLENE STREET	kirshon ave	S|P	4
Arlington Ave	s/of arlington	T	206
Arlington Pl	e/of arlington a|s/of grandview|e/of northfield|w/of arlington a|n/of arlington|s/of arlington|w/of arlington|e/of grandview|s/of arlington a|e/of arlington	T	129
ARLINGTON PL		P	4
Arlo Rd	s/of stratford a|s/of stratford|w/of stratford a|s/of howard av|w/of stratford|s/of howard ave|s/of forest av|n/of howard ave|n/of howard av|n/of stratford a|e/of stratford|w/of howard ave	T	617
ARLO RD	stratford	P	15
Armour Pl	e/of ormsby ave	T	15
ARMSTRONG AVE		P	7
Armstrong Ave	n/of middle loo|e/of e reading|e/of amboy rd|s/of amboy rd|s/of hylan blvd|n/of amboy rd|n/of leverett|n/of e scranton|s/of e stroud a|s/of leverett a|e/of e stroud av|w/of wilson ave|w/of e reading|n/of e scranto	T	107
ARMSTRONG AVENUE		S|P	4
Arnold St	e/of york ave|e/of lafayette	T	40
Arnprior St	s/of riegelmann|n/of riegelmann|n/of forest ave|s/of forest ave|s/of forest av	T	15
Arthur Ave	w/of cedar ave|e/of robin rd|s/of cedar ave	T	29
Arthur Kill Rd	n/of bentley st|s/of hervey st|s/of huguenot|e/of e service|w/of aspen knol|s/of johnson st|e/of w service|n/of storer ave|e/of huguenot a|w/of e service|n/of carlyle gr|w/of veterans r|w/of hervey st|e/of veterans|s/of grille ct|s/of west shor|w/of carlyle gr|s/of cody pl|w/of w service|n/of other-see|s/of englewood|w/of johnson st|n/of huguenot|s/of rossville|s/of industrial|e/of amanda ct|s/of arden ave|e/of veterans r|n/of kristen ct|e/of huguenot|s/of e service|e/of rossville|e/of arden ave|s/of storer ave|w/of carlyle g|e/of ilyssa wa|e/of revere ln	T	326
ARTHUR KILL RD	winant pl|brookfield ave	P	25
ARTHUR KILL ROAD		P|S	10
Ash Pl	e/of warwick av	T	18
Ashland Ave		T	34
Ashton Dr	n/of dogwood dr|s/of mimosa ln|s/of dogwood dr	T	17
Ashwood Ct	s/of redwood ave|e/of redwood ave	T	6
Ashworth Ave	s/of carpenter|s/of cooper ter|e/of forest hi|w/of shepard a|e/of grissom ave|s/of shepard av|e/of grissom av|n/of forest hi|w/of shepard ave|w/of forest hil|s/of cooper te|w/of cooper ter|e/of shepard av|w/of grissom a|e/of cooper ter	T	32
Aspinwall St		T	39
Astor Ave		T	28
Athena Pl		T	19
Atlantic Ave	n/of hylan blvd|e/of hylan blvd|s/of hylan blvd|n/of laconia ave	T	188
ATLANTIC AVE		P	4
Auburn Ave	e/of collfield	T	14
Augusta Ave	n/of richmond a|n/of richmond av|w/of richmond a|s/of richmond a	T	35
Aultman Ave	e/of richmond r	T	6
Austin Ave		T	11
Austin Pl	e/of victory b|n/of ward ave|s/of natalie ct|w/of victory bl|w/of victory b|w/of ward ave|s/of victory b	T	118
AUSTIN PL		P	4
Avenue B	s/of bennett st	T	33
Averill Pl	s/of nassau pl	T	4
Aviston St	s/of riga st	T	19
Avon Pl	e/of edgar ter|w/of ward ave	T	76
AVON PL		P	4
Aye Ct	e/of felton st	T	5
Aymar Ave	e/of little clo	T	10
Bache Ave	s/of edison st|n/of hylan blvd|n/of edison st	T	69
Bache St	w/of jewett ave	T	8
Baden Pl	e/of hempstead|e/of hempstead a	T	30
Bailey Pl	s/of midland av	T	25
Ballard Ave	s/of sperry pl	T	13
Balsam Pl	w/of rossville|e/of rossville|n/of rossville|s/of arrowood c|s/of rossville|s/of ivy ct	T	42
Baltic Ave	s/of targee st|w/of targee st|e/of roosevelt	T	33
Baltic St	w/of van duzer|n/of bay st|n/of van duzer	T	11
Baltimore St		T	26
Bamberger Ln		T	7
Bancroft Ave		T	14
Bangor St		T	10
Bank St	e/of richmond|w/of jersey st|n/of jersey st|e/of jersey st|w/of richmond|s/of jersey st|e/of richmond te	T	78
Barbara St	e/of e broadway	T	46
Barclay Ave		T	48
Barclay Cir		T	6
Bard Ave	s/of castleton|s/of s st austin|n/of s st austi|s/of moody pl|e/of s st austi|w/of forest ave|w/of s st austi|e/of castleton|w/of delafield p|n/of s st austin|w/of n st aust|s/of henderson|s/of richmond te|e/of n st austi|n/of delafield|s/of s st austi|n/of castleton|n/of forest ave|e/of richmond t|e/of rokeby pl|n/of richmond t|w/of n st austi|s/of n st austi|s/of richmond t|n/of castleton a|s/of forest ave|n/of henderson|s/of castleton a|n/of linden st	T	3728
BARD AVE		P	14
Barker St	e/of castleton|n/of castleton	T	119
Barlow Ave	e/of armstrong a|n/of ridgewood|w/of eltingvill|w/of doane ave|e/of colon ave|e/of abingdon|w/of elverton a|e/of ridgewood a|e/of getz ave|s/of getz ave|w/of ridgewood|w/of armstrong|e/of elverton a|e/of abingdon a|e/of armstrong|s/of ridgewood a|n/of eltingvill|w/of brookfield|n/of abingdon a|s/of abingdon a	T	126
BARLOW AVE		P	5
Barnard Ave	s/of arthur kill	T	56
Baron Blvd	e/of wakefield|n/of victory bl|s/of wakefield|e/of latimer av|e/of victory bl|s/of latimer av	T	24
Barrett Ave	e/of decker ave|n/of forest ave|w/of forest av|s/of decker av	T	95
Barrow Pl	e/of alverson|n/of alverson a|s/of alverson a|s/of mallow st|w/of alverson a	T	25
Barry St	e/of rossville|w/of barry ct|w/of rossville|w/of bar ct|w/of schindler c|s/of barry ct|n/of rossville|s/of rossville|s/of iris ct|n/of barry ct|e/of bar ct	T	70
Bartlett Ave	s/of lamoka ave|s/of gurley ave|n/of richmond av	T	153
Barton Ave	s/of richmond r	T	12
Bartow Ave	s/of page ave	T	18
Bartow St		T	11
Bascom Pl	e/of stewart ave|w/of collfield a	T	36
Bass St	e/of carmel ave|w/of carmel ave	T	4
Bath Ave	n/of hylan blvd|w/of hylan blvd|s/of s railroad	T	20
Bathgate St	n/of harold ave|s/of harold ave	T	13
BAY ST	edgewater st|school rd	P	23
Bay St	s/of victory blv|e/of union ave|w/of prospect|e/of thompson|s/of canal st|s/of st marys a|s/of swan st|s/of willow ave|n/of victory blv|s/of broad st|n/of prospect st|s/of church ln|s/of slosson te|w/of canal st|n/of st marys a|s/of prospect s|n/of slosson te|e/of slosson te|n/of slosson ter|e/of willow ave|w/of water st|n/of scarboro av|e/of victory bl|w/of swan st|s/of prospect st|s/of townsend a	T	5552
BAY STREET		P|S	72
Bay Street Landing		T	7
Bay Ter	s/of amboy rd|e/of amboy rd|w/of amboy rd|n/of hylan blvd	T	141
Bayard St	e/of wilson ave|n/of wilson ave|w/of wilson ave|s/of wilson ave	T	76
Bayview Ave	s/of hylan blvd	T	36
BAYVIEW PL		P	5
Bayview Pl	w/of creston pl	T	23
Bayview Ter	e/of barclay ave|w/of peare pl	T	13
Beach Ave	n/of new dorp p	T	112
Beach Rd		T	26
Beach St	n/of union pl|w/of van duzer|e/of union pl|n/of jackson st|s/of water st|e/of van duzer|n/of water st|e/of water st|e/of van duzer s	T	255
BEACH ST		P	6
Beacon Ave		T	22
Beacon Pl		T	7
BEACON PLACE		P	4
Bear St	e/of alter ave	T	14
BEARD ST		P	4
Beard St	n/of travis ave	T	9
Bedell Ave	e/of hylan blvd|w/of hylan blv|n/of giegerich|s/of giegerich|e/of giegerich|s/of hylan blv|s/of hylan blvd	T	73
Bedell St		T	26
Bedford Ave	s/of mason ave|s/of moreland st|s/of husson st|n/of hylan blvd|w/of laconia av	T	98
BEDFORD AVE		P	7
BEDFORD AVENUE		S	9
Bee Ct	n/of gauldy av|e/of gauldy ave|e/of gauldy av|n/of gauldy ave	T	5
Beechwood Ave	e/of crescent|n/of crescent a|s/of cleveland p|w/of dongan ave|e/of dongan ave|e/of governor r|n/of governor r|s/of crescent a|s/of cleveland|w/of dongan av|n/of dongan ave|s/of governor r	T	69
Beechwood Pl	n/of dongan ave|w/of dongan ave|s/of governor r|w/of governor rd|e/of victory bl|s/of sturges st|s/of governor|e/of governor|e/of governor r|s/of dongan ave|n/of victory bl|e/of governor rd|n/of governor	T	62
Beekman St	e/of lagrange p|w/of lagrange p|s/of port richmo	T	22
Beethoven St		T	6
Behan Ct	e/of amboy rd|w/of francine c	T	5
Belair Rd	w/of tompkins|e/of tompkins a|w/of tompkins a|w/of bay st	T	56
BELAIR RD		P	11
Belfast Ave		T	39
Belfield Ave	n/of n railroad|w/of crown ave|n/of annadale|n/of woodrow rd	T	95
Bell St	w/of white plai|e/of white plai|w/of reynolds s|s/of white plai	T	34
Bellhaven Pl		T	9
Belmont Pl	s/of fort pl|w/of fort pl|s/of vine st|e/of wall st|e/of fort pl|n/of fort pl|e/of daniel low	T	197
BELMONT PL		P	10
BELMONT PLACE		P|S	7
Bement Ave	n/of richmond t|n/of castleton|n/of morrison|w/of green st|e/of castleton|s/of forest ave|n/of starr ave|e/of starr ave|s/of green st|s/of starr ave|s/of richmond t|w/of richmond a|e/of green st	T	343
Bement Ct		T	6
Benedict Ave	w/of manor rd	T	38
BENJAMIN DR		P	10
Benjamin Pl	s/of holland av|w/of holland av|n/of richmond t|n/of holland av|e/of holland av|e/of holland ave|n/of holland ave|w/of northfield	T	112
Bennett Ave	e/of park ave|e/of port richmo	T	39
Bennett Pl		T	20
Bennett St	w/of heberton a|w/of park ave|w/of heberton|w/of port richmo|s/of park ave|e/of port richm|e/of heberton a|s/of port richm|e/of port richmo|n/of park ave	T	120
Benson St	e/of kenilworth|e/of bay st|w/of kenilworth	T	19
Bent St	w/of van brunt s	T	10
Bentley St	n/of arthur kil|w/of arthur kil	T	24
Benton Ave	s/of laconia av|e/of hylan blvd|n/of laconia av|n/of hylan blvd|w/of cooper ave|e/of jerome rd	T	42
Benton Ct		T	5
Benziger Ave	e/of westervel|e/of daniel low|s/of sherman av|w/of sherman av|e/of jersey st|e/of westervelt|w/of daniel low|n/of westervelt|n/of daniel low|n/of sherman av|w/of monroe ave|n/of westervel|s/of daniel low|w/of winter ave|w/of westervelt|e/of sherman av|e/of daniel lo	T	214
BENZIGER AVE		P	4
Beresford Ave	w/of wild ave	T	22
Berglund Ave		T	63
Berry Ave		T	23
Bertha Pl	w/of eddy st|e/of eddy st|s/of eddy st|n/of theresa pl	T	49
Bertram Ave		T	5
Beth Pl	s/of holly ave|e/of holly ave|w/of montvale p	T	7
Bethel Ave	w/of maiden ln|s/of lenhart st	T	37
Beverly Ave	n/of melrose av	T	19
Beverly Rd	e/of steuben st|w/of steuben st	T	55
Bidwell Ave	s/of lathrop ave|n/of college av	T	25
Billings St	w/of woodrow rd|w/of luten ave	T	12
Billiou St	s/of prall ave|w/of androvett|e/of luten ave|n/of luten ave|w/of prall ave|s/of luten ave|w/of luten ave|w/of androvette|e/of prall ave|s/of huguenot av|s/of androvette	T	54
Billop Ave	e/of main st|e/of chelsea st|e/of brighton a|e/of loretto st	T	16
Bionia Ave	n/of olympia blv|n/of olympia bl|e/of hylan blvd|e/of foch ave	T	68
Birch Ave	w/of metropolit|e/of bard ave|w/of bard ave	T	10
Birch Rd		T	79
Birchard Ave	n/of sunset ave	T	28
Bishop St	w/of ebony st|n/of amboy rd|w/of dalton ave|n/of ebony st|e/of richmond r	T	36
Bismark Ave	n/of scribner a|e/of winter av|s/of benziger av|n/of crescent a|s/of scribner av|n/of benziger a|e/of taft ave|w/of crescent av|s/of layton ave|s/of taft ave|e/of crescent a|n/of hendricks|n/of taft ave|e/of benziger av|s/of layton av|n/of winter ave|s/of winter av|s/of winter ave|e/of hendricks|s/of benziger a|s/of hendricks|s/of crescent a|n/of scribner|w/of hendricks|e/of benziger a	T	81
Blackford Ave	n/of nicholas av|w/of port richm|n/of port richm|s/of port richm|w/of nicholas a|e/of treadwell|w/of nicholas av|e/of nicholas a|n/of nicholas a|s/of nicholas av|e/of nicholas av	T	138
Blaine Ct		T	4
Bland Pl		T	5
Bleeker Pl	w/of toddy ave	T	20
Block St	s/of spratt ave|w/of spratt ave|e/of spratt ave|e/of hopkins av	T	16
Bloomfield Ave	w/of gulf ave	T	6
Bloomingdale Rd	n/of herrick av|w/of kramer av|e/of mandy ct|n/of wirt ave|s/of mason blvd|e/of alysia ct|w/of herrick av|s/of pitney ave|s/of kramer av|n/of lucille av|s/of alysia ct|s/of lucille av|w/of churchill|s/of herrick av|s/of candon ave|n/of herrick ave|s/of churchill|w/of alysia ct|w/of pitney av|n/of churchill|s/of wirt ave|e/of mason blv|e/of herrick av|s/of arthur kil|w/of marisa cir|s/of correll ave|n/of pitney ave|e/of englewood|e/of lucille av	T	202
BLOOMINGDALE ROAD	wirt ave	S|P	8
Blueberry Ln	n/of arden ave	T	25
Blythe Pl	s/of cotter ave	T	11
BLYTHE PL		P	8
Bodine St	s/of richmond t|n/of castleton	T	28
BODINE STREET		S	6
Bogert Ave		T	5
Bogota St	e/of travis ave	T	13
Bolivar St	s/of manor rd	T	55
BOMBAY ST		P	12
Bombay St	s/of mason blvd	T	9
Bond St	w/of jewett ave|e/of heberton av|n/of heberton a	T	70
BOND ST		P	15
Boone St	w/of fields ave	T	9
Booth Ave	e/of amboy rd|s/of amboy rd	T	5
Borman Ave		T	8
Boscombe Ave		T	7
Boulder St	n/of woodrow rd|e/of castor pl	T	39
Boundary Ave	w/of greeley av|e/of hylan blvd|e/of zwicky ave|n/of zwicky ave|w/of midland a|w/of midland av|w/of lincoln av|n/of hylan blvd|e/of midland av|n/of hamden ave|s/of hunter ave|w/of zwicky ave|s/of zwicky ave|n/of midland av	T	96
Bovanizer St		T	6
Bowdoin St		T	23
Bowen St	n/of sobel ct|s/of roff st|e/of roff st|e/of sobel ct|e/of targee st|w/of soren st|w/of sobel ct	T	151
Bower Ct	s/of nelson ave	T	4
Bowles Ave	e/of morningstar|n/of morningstar|s/of morningsta|w/of morningsta	T	39
Bowling Green Pl	w/of rockville|s/of mulberry av|e/of rockville a|w/of rockville a	T	36
Boyce Ave		T	13
Boyd St		T	18
BOYD ST		P	4
Boylan St		T	10
Boyle Pl		T	4
Brabant St	s/of grandview|s/of union ave|n/of harbor rd|e/of grandview|e/of harbor rd|w/of grandview|n/of grandview|s/of harbor rd|s/of lockman av|w/of lockman av|w/of harbor rd	T	281
BRABANT ST		P	6
Bradford Ave	s/of foster ave|w/of foster rd	T	26
Bradley Ave	n/of brielle av|n/of oakville st|n/of brielle ave	T	36
Braisted Ave	w/of evans st|n/of evans st|w/of denker pl|n/of nehring ave|s/of nehring ave|s/of denker pl|e/of evans st|e/of nehring ave|e/of denker pl|s/of kelly blvd	T	108
Brehaut Ave	e/of craig ave	T	18
Brenton Pl	n/of victory bl|n/of victory b|n/of victory blv	T	35
Brentwood Ave		T	7
Brewster St	n/of clinton st|n/of clinton s|n/of william st|s/of clinton st	T	40
Briarcliff Rd	e/of radcliff|s/of beverly r	T	6
Briarwood Rd	s/of birch rd|e/of amador st|w/of amador st|w/of birch rd|e/of birch rd|n/of amador st	T	33
BRICKTOWN WAY		P	8
Bridgetown St		T	48
Brielle Ave	n/of mountainvi|e/of gansevoort|e/of wellbrook	T	50
BRIELLE AVE	suffolk ave	P	23
Brighton Ave	s/of stanley av|e/of portland p|s/of castleton a|e/of clove rd|s/of portland pl|s/of portland p|w/of stanley ave|s/of castleton|n/of stanley av	T	113
Brighton St	s/of billop ave|n/of hylan blvd|e/of clearmont a	T	70
Bristol Ave	w/of cypress av	T	12
Britton Ave	e/of clove rd|s/of clove rd|n/of dekalb st|n/of clove rd	T	93
Britton St	e/of broadway|e/of e broadway|w/of broadway|s/of broadway	T	52
BRITTON ST		P	8
BROAD ST		P	27
Broad St	e/of bay st|n/of gordon st|s/of cedar st|w/of bay st|w/of targee st|e/of union pl	T	395
BROAD STREET		P	12
Broadway	n/of taylor st|s/of cary ave|n/of w raleigh|w/of henderson|s/of henderson|s/of wayne st|n/of henderson|n/of market st|n/of castleton|w/of castleton|s/of britton st	T	476
BROADWAY		S|P	21
Brook Ave	n/of william st|s/of fairbanks	T	21
Brook St	s/of fremont st|e/of westervelt|w/of fremont st|e/of westervel	T	77
BROOKFIELD AVE		P	11
Brookfield Ave	n/of leverett av	T	112
Brooks Pl	n/of floyd st	T	7
BROOKSIDE LOOP		P	6
Brower Ct	e/of giffords l|w/of nelson ave|e/of nelson ave|s/of nelson ave|w/of giffords l|n/of giffords l|w/of giffords ln|n/of nelson ave	T	188
Brown Pl		T	10
Brownell St	n/of tompkins|w/of tompkins	T	59
BRUCKNER AVE		P	4
Bruckner Ave	s/of forest ave|w/of forest ave|e/of forest ave|n/of forest ave|n/of wilcox st|n/of forest av|s/of wilcox st	T	73
BRUNSWICK ST		P	4
Brunswick St		T	8
Bryan St	e/of summit st	T	5
Bryant Ave		T	19
Bryson Ave		T	73
Buchanan Ave	n/of willowbrook	T	35
Buel Ave	s/of mason ave|s/of hylan blvd|n/of husson st|e/of hylan blvd|w/of hylan blvd|n/of jefferson s|n/of hylan blvd|s/of richmond rd|e/of nugent ave|n/of mason ave	T	287
BUEL AVE		P	14
BUEL AVENUE		S|P	7
Buffalo St	w/of sheridan c	T	6
Bunnell Ct		T	21
Burbank Ave	s/of richmond rd|e/of richmond r|s/of richmond r|w/of clawson st|n/of 3rd st|n/of clawson st|n/of hylan blvd	T	56
Burden Ave		T	23
Burgher Ave	s/of n railroad|w/of adele st|e/of n railroad|s/of hylan blvd|s/of henry pl|n/of n railroad|s/of adele st|s/of s railroad|n/of hylan blvd	T	131
BURKE AVE		P	9
Burke Ave	w/of victory bl|n/of victory blv	T	43
Burnside Ave	e/of forest ave|w/of forest ave|n/of forest ave|s/of forest ave|n/of forshay st	T	133
Burton Ave		T	12
Bush Ave	s/of richmond te|w/of richmond t|s/of richmond t	T	94
BUSH AVE		P	4
Butler Ave	s/of arthur kil|e/of arthur kil|e/of ormond pl	T	11
BUTLER AVE		P	6
Butler Pl	e/of ormond pl|s/of anderson st|w/of ormond pl	T	16
Byrne Ave	e/of victory blv	T	55
C/O BAY ST	willow ave	P	6
C/O BROADWAY	richmond terr	P	4
C/O FATHER CAPODANNO	buel ave|seaview	P	5
C/O FR CAP BLVD	naughton|kramer av|i/o seaview ave|i/o	P	6
C/O HENDERSON AVE	caldera pl	P	4
C/O PIKE ST	brook st	P	5
C/O TILLMAN ST	manor rd	P	4
C/O VETERANS RD E	arthur kill rd|arthur kill	P	14
Cabot Pl	w/of belair rd	T	5
Caldera Pl		T	8
CALVANICO LN		P	4
Calvin St	e/of pearl st|w/of pearl st|s/of pearl st	T	5
Cambria St	s/of piave ave	T	8
Cambridge Ave	n/of wyona ave|n/of auburn ave|s/of watchogue|e/of watchogue|n/of auburn av	T	36
Camden Ave	s/of page ave|n/of page ave|e/of page ave	T	25
Cameron Ave		T	16
CAMPBELL AVE		P	5
Campbell Ave	e/of market st|s/of henderson|s/of market st|n/of market st	T	56
CAMPBELL AVENUE		P|S	4
Campus Rd	w/of howard ave|s/of howard ave|s/of howard av|w/of howard av|e/of howard av|e/of howard ave|n/of howard av|w/of starlight	T	226
CAMPUS RD		P	5
Canal St	e/of beach st|e/of broad st|n/of broad st|e/of front st|e/of bay st|w/of bay st|s/of broad st|w/of front st|e/of wright st|n/of front st	T	1160
CANAL ST		P	4
CANAL STREET		P	10
Candon Ave	s/of phyllis ct	T	23
Cannon Ave	n/of phyllis c|w/of victory bl	T	31
CANNON AVE	victory blvd	P	6
Cannon Blvd	n/of 10th st	T	27
Canterbury Ave	s/of victory bl|s/of manor rd	T	25
CANTON AVE		P	5
Canton Ave		T	18
CAPODANNO BLVD	seaview ave|sand lane|hunter ave	P	8
Cardiff St	w/of castor pl	T	13
Carlton Ave	w/of crown ave	T	8
CARLTON AVE		P	5
Carlton Blvd	e/of ionia ave|n/of crown ave|e/of woodrow rd|e/of arden ave|s/of woodrow rd|n/of stafford a|w/of woodrow rd|n/of arden ave|w/of arden ave|w/of huguenot a	T	82
CARLTON BLVD		P	4
Carlyle Green	w/of poets cir|s/of poets cir	T	28
Carmel Ave	e/of victory bl|e/of victory blv|s/of victory blv|s/of victory bl|n/of victory bl|n/of forest ave	T	84
Carnegie Ave		T	26
Carol Pl		T	4
Caroline St	n/of cary ave|w/of davis ave|s/of cary ave|s/of castleton	T	58
Carpenter Ave	w/of slayton ave	T	33
Carreau Ave		T	5
Carroll Pl	w/of nicholas|n/of st peters p|w/of st peters|e/of westervelt|e/of st peters p|s/of westervel|e/of westervel|s/of st peters|e/of st peters|n/of st peters|w/of st peters p|w/of nicholas s|e/of st pauls a|s/of st peters p|s/of westervelt|e/of nicholas|n/of nicholas s	T	335
Carteret St		T	56
Cary Ave	e/of bement av|s/of bement ave|w/of caroline s|e/of broadway|w/of broadway|e/of elizabeth s	T	299
CARY AVE		P	4
Cascade St		T	11
Case Ave	n/of melville st|s/of keating st|w/of melville s|w/of melville st|e/of keating st|n/of melville s|e/of norman pl|e/of melville|e/of melville st|n/of keating st	T	45
Cassidy Pl	w/of clinton a|n/of clinton ave|e/of lafayette a|s/of clinton ave|w/of lafayette|e/of clinton av|n/of clinton a|s/of lafayette|e/of lafayette|e/of tysen st|w/of tysen st|s/of clinton av|n/of tysen st	T	163
CASSIDY PL	lafayette ave	P	4
Castleton Ave	e/of heberton|w/of caroline s|n/of oxford pl|e/of harbor view|n/of jersey st|w/of bard ave|n/of haven espl|s/of harbor vie|n/of alaska st|s/of park ave|w/of n burgher|s/of treadwell a|s/of cebra ave|w/of hoyt ave|e/of faber st|s/of jersey st|e/of port richm|e/of davis ave|e/of harbor vie|w/of n randall|w/of treadwell a|w/of park ave|w/of port richm|e/of treadwell|e/of cebra ave|e/of caroline st|e/of hoyt ave|e/of jersey st|w/of davis ave|w/of baker pl|e/of sharpe av|n/of cebra ave|e/of park ave|w/of broadway|w/of oxford pl|n/of park ave|w/of haven espl|e/of pelton ave|e/of bodine st|w/of faber st	T	2590
CASTLETON AVE		P	27
CASTLETON AVENUE		P|S	8
Castleton Ct		T	9
Castor Pl	e/of huguenot|w/of anaconda s	T	30
Caswell Ave	e/of livermore|w/of tremont av|e/of canterbury|e/of woolley av|w/of orinoco p|s/of canterbury|e/of tremont av|e/of stewart av	T	66
Caswell Ln	w/of elson st|s/of elson st|e/of elson st	T	27
Catherine Ct	e/of jewett ave|w/of jewett ave|e/of simonson	T	12
Catherine St	w/of lexington|e/of lagrange p|s/of decker av	T	108
Catlin Ave		T	15
Cattaraugus St	w/of little clo	T	20
Cayuga Ave	s/of tioga st|w/of oswego st|w/of schoharie s	T	41
Cebra Ave	e/of dyson st|s/of chester pl|n/of victory bl|e/of chester pl|w/of oxford pl|s/of rosewood p|e/of victory bl|e/of castleton|w/of victory bl|w/of rosedale a|n/of rosewood p|e/of rosewood p|w/of chester pl|s/of victory bl|s/of rosewood pl|w/of victory b	T	87
Cedar Ave	e/of sand ln|e/of conger st|e/of arthur ave|e/of broad st|s/of ocean ave|e/of n railroad|w/of railroad a|s/of arthur ave	T	79
CEDAR AVE		P	22
Cedar Grove Ave	e/of waterside|w/of new dorp l|w/of new dorp ln	T	14
Cedar St	w/of hudson st|s/of boyd st|e/of broad st|e/of hudson st|n/of broad st|w/of broad st	T	79
Cedar Ter		T	61
Cedarview Ave	w/of n railroad|n/of n railroad|s/of richmond av|e/of n railroad	T	72
Cedarwood Ct	e/of yale st|w/of yale st|n/of yale st	T	28
Celtic Pl	n/of winham ave|n/of winham av|w/of winham ave|s/of weed ave	T	21
Center Pl		T	16
CENTER PLACE		S	8
Center St		T	57
Central Ave	w/of slosson ter|s/of slosson t|s/of slosson a|s/of slosson ter|n/of bay st|n/of victory bl|s/of hyatt st|s/of slosson te|e/of hyatt st|n/of hyatt st|n/of victory b|n/of slosson te|n/of slosson ter|w/of bay st|s/of bay st|w/of hyatt st	T	1450
CENTRAL AVE		P	8
Champlain Ave	s/of platt st|n/of platt st	T	48
CHANDLER AVE		P	5
Chandler Ave	e/of jewett ave	T	46
Chapin Ave		T	9
Chappell St	w/of henderson a|s/of henderson|e/of wayne st|w/of henderson|n/of henderson|s/of wayne st|n/of alaska st|n/of wayne st	T	39
Charles Ave	w/of port richm|w/of port richmo|e/of treadwell|e/of sharpe av|n/of st josephs|s/of castleton a|e/of st josephs|w/of nicholas av|s/of nicholas a|w/of st josephs|e/of crittenden|w/of nicholas a|w/of nicholas|e/of st joseph|e/of nicholas a|e/of nicholas av|w/of st joseph|s/of st josephs	T	175
CHARLES AVE		P	5
Charleston Ave	s/of hickory ct|e/of hickory ct	T	84
Chatham St		T	8
Chelsea Ave	e/of amboy rd	T	17
Chelsea Rd		T	15
Chelsea St	e/of amboy rd|s/of amboy rd|w/of amboy rd	T	49
Cherry Pl	s/of gansevoort|w/of gansevoort	T	12
Cherrywood Ct	e/of sandalwoo	T	30
Cheryl Ave		T	15
Chesebrough St	w/of petrus ave	T	15
Cheshire Pl		T	23
Chester Ave	e/of irvington	T	12
Chester Pl	s/of cebra ave|n/of clark ln	T	32
Chesterton Ave		T	62
Chestnut Ave	w/of anderson a|e/of tompkins|w/of bay st|w/of tompkins av	T	167
Chestnut Cir		T	5
Chestnut St	e/of van duzer|n/of van duzer|e/of van duzer s	T	7
Cheves Ave	s/of watchogue	T	5
Chicago Ave	e/of columbia av|e/of columbia|e/of cleveland|n/of columbia a|s/of cleveland|s/of columbia a	T	25
Chisholm St	w/of eylandt st|n/of eylandt s|n/of eylandt st|e/of akron st|s/of amboy rd|s/of eylandt s|e/of eylandt s|e/of amboy rd|e/of eylandt st|s/of eylandt st|w/of luten ave|n/of amboy rd|w/of eylandt s|w/of amboy rd	T	96
CHRISTOPHER LANE	crotona plc|croton pk|akron st|croton pl	P	6
Christopher lane & A	kron st|kron	S	15
Christopher lane & C	roton pl	S	11
Christopher Ln	w/of richmond a|s/of richmond a|e/of richmond a|s/of akron st|s/of genesee av|s/of yona ave|s/of croton ave|n/of akron st|w/of akron st|e/of yona ave|n/of yona ave|w/of yona ave|e/of akron st|e/of croton ave	T	93
CHRISTOPHER LN	croton pl|akron st	P	13
Christopher St	s/of grandview a|w/of mersereau|e/of grandview|e/of akron st|s/of andros ave|e/of mersereau|s/of akron st|s/of mersereau a|n/of mersereau	T	143
CHRISTOPHER ST	mersereau ave	P	5
Church Ave	s/of victory blv|e/of park ave|w/of victory bl	T	10
Church St	e/of park ave|e/of port richm|n/of park ave|w/of port richm	T	26
Churchill Ave		T	39
City Blvd	s/of forest ave|e/of forest ave|e/of crosshill|n/of crosshill|s/of crosshill s|e/of parsons pl|n/of parsons pl|n/of forest av	T	43
Clark Ln	w/of chester pl|s/of chester pl	T	14
Clark Pl	w/of eldridge a|w/of eldridge av	T	20
Claudia Ct		T	6
Clawson St	n/of bancroft a|e/of bancroft a|e/of new dorp l|s/of guyon ave|e/of allison av|e/of bache ave|s/of greeley av|s/of bryant ave|s/of new dorp ln|w/of tysens ln|e/of bryant ave|w/of allison ave|n/of otis ave|w/of new dorp l|w/of coddington|e/of coddington|s/of new dorp l|s/of jacques av|w/of new dorp ln|n/of new dorp l|w/of jacques av|w/of new dorp|w/of princeton a|s/of rose ave|w/of jacques ave|n/of prescott a|w/of guyon ave|w/of beach ave|e/of jacques ave|e/of jacques av|w/of bache ave|e/of new dorp ln|n/of new dorp ln|w/of otis ave|s/of fremont a|s/of bancroft av|s/of prescott a	T	712
Clay Pit Rd		T	73
Clearmont Ave	s/of manhattan|e/of finlay st|e/of connecticu|w/of manhattan|e/of carteret|e/of rockaway|n/of manhattan s|s/of manhattan s|e/of carteret s	T	35
Clermont Ave	s/of carteret|s/of rockaway s|s/of yetman ave|w/of manhattan|w/of yetman ave|w/of swinnerton|w/of finlay st	T	22
CLERMONT AVE		P	6
Clermont Pl		T	10
Cletus St		T	8
Cleveland Ave	s/of richmond t|n/of hylan blv|e/of fingerboar|n/of hylan blvd|s/of hylan blvd|e/of locust pl	T	108
Cleveland Pl	w/of fingerboa|w/of chicago a|n/of landis av|e/of fingerboa	T	28
CLEVELAND PLACE		P	4
Cleveland St		T	21
Cliff St	e/of bay st|s/of cliff ct|w/of bay st	T	80
Cliffside Ave	w/of targee st|e/of targee st	T	27
Clifton Ave	w/of edgewater|n/of rockwell a|n/of tompkins|e/of tompkins av|n/of tompkins a|w/of anderson a|n/of henderson a|e/of vermont av|w/of tompkins av|w/of vaughan st|s/of bay st|w/of bay st|s/of vermont av|e/of bay st|w/of vermont ave|n/of tompkins av|e/of tompkins a|w/of fox hill t|n/of edgewater|w/of vermont av|e/of richmond a	T	182
CLIFTON AVE		P	8
CLIFTON AVENUE		P	4
Clifton St	e/of richmond a|w/of richmond|w/of richmond a|w/of victory bl	T	29
Clinton Ave	w/of richmond t|w/of van duzer s|e/of henderson|n/of cassidy pl|e/of st pauls|s/of henderson|s/of richmond t|w/of henderson|n/of prospect a|w/of richmond te	T	130
CLINTON AVE		P	10
Clinton B Fiske Ave	s/of leonard ave	T	31
Clinton Pl	s/of port richm|e/of port richmo|w/of port richm|e/of port richm|n/of heberton|e/of nicholas a|w/of heberton a|e/of nicholas av|w/of treadwell|n/of heberton a|e/of treadwell	T	82
CLINTON PLACE		P	4
Clinton St	e/of st pauls|e/of st pauls a|w/of van duzer s|w/of bay st|w/of brewster st	T	46
Cloister Pl	n/of n railroad|e/of 3rd st|n/of 3rd st|s/of richmond rd|s/of 3rd st	T	26
Clove Lake Pl	w/of elizabeth s|n/of allen ct|w/of elizabeth|w/of clove rd|w/of broadway|n/of forest ave|e/of broadway|s/of broadway|n/of broadway	T	180
CLOVE RD	martling ave	P	76
Clove Rd	w/of bement ave|n/of allen ct|w/of hylan blvd|e/of cornell a|s/of clove way|e/of britton av|w/of clove way|s/of ludwig st|w/of weser ave|s/of richmond t|n/of forest ave|s/of allen ct|weser av|n/of cheshire p|w/of richmond t|n/of richmond t	T	270
CLOVE ROAD		S|P	24
Cloverdale Ave		T	5
Clovis Rd	n/of clove way	T	7
Clyde Pl	e/of prospect a	T	6
Coale Ave	w/of s greenle|e/of jewett ave|w/of jewett ave|n/of jewett ave|s/of jewett ave|s/of s greenle|s/of westcott bl|e/of jewett av|e/of westcott bl|s/of s greenleaf	T	247
CODDINGTON AVE		P	5
Coddington Ave	w/of hylan blvd|s/of clawson s	T	119
Cody Pl	n/of platt st|e/of arthur ki|n/of pratt ct|n/of arthur ki|s/of arthur ki|e/of lombard ct|s/of pratt ct|e/of pratt ct|s/of country ln|s/of arthur kil|n/of lombard c|w/of lombard ct|w/of arthur ki|e/of arthur kil	T	83
COLFAX AVE		P	14
Colfax Ave	n/of s railroad|n/of clawson st|s/of s railroad|s/of edison st|n/of richmond r	T	103
Colgate Pl	w/of princeton a|e/of cannon blv|w/of princeton|e/of princeton	T	5
College Ave	s/of willowbroo|e/of willowbroo	T	73
COLLEGE AVE		P	5
COLLFIELD		P	4
Collfield Ave	n/of n gannon a|w/of willowbroo	T	124
Colon Ave	w/of gurley ave	T	58
Colon St		T	5
Colonial Ave	w/of field st|s/of norwich st|w/of pilcher st|s/of steers st|s/of pilcher s|s/of pilcher st|n/of norwich st|n/of field st|e/of pilcher st|n/of pilcher st	T	20
Colony Ave	s/of midland av|e/of lincoln av|e/of greeley ave|w/of midland av	T	51
Colorado St	w/of college av|n/of college av	T	5
Colton St	s/of hylan blv|s/of hylan blvd|s/of st john av|e/of st johns|n/of st johns|s/of st johns|s/of maryland|n/of maryland a	T	63
Columbia Ave	n/of fingerboar|w/of fingerboa	T	33
Columbus Ave	w/of targee st|e/of targee st|w/of w fingerbo|n/of richmond r|e/of richmond r	T	96
Columbus Pl	e/of muller ave|e/of glascoe a|w/of glascoe av	T	10
Comely St	w/of kingdom a|e/of huguenot|e/of page ave	T	5
Commerce St	w/of arlene st	T	55
Comstock Ave		T	54
Concord Pl	e/of starbuck s|e/of richmond r	T	5
Confederation Pl	e/of union ave|w/of union ave	T	25
Congress St	e/of bay st|w/of bay st	T	21
Connecticut St		T	38
Connor Ave	e/of pinewood a|n/of victory bl	T	24
Conrad Ave	s/of ashworth|w/of ainsworth|e/of ainsworth|s/of ashworth a|w/of anderson|e/of field st|e/of greenway a|n/of greenway a	T	49
Constant Ave	w/of manor rd|e/of jewett ave|e/of manor rd	T	48
Continental Pl	n/of union ave|e/of lockman ave|e/of union ave|e/of gridley av|e/of maple pky|e/of lockman av|s/of maple pky|n/of lockman ave|s/of mersereau|w/of maple ave	T	170
CONTINENTAL PL		P	8
Conyingham Ave		T	21
Cooke St	s/of comstock av	T	19
Cooper Ave		T	18
Cooper Pl	s/of case ave	T	7
Cooper Ter	n/of rockland av|e/of rockland av|s/of ashworth a	T	37
Copley St		T	35
Copperleaf Ter		T	4
Corbin Ave	n/of dewey ave|n/of redwood ave|n/of country w|s/of arthur ki|s/of country w|w/of redwood ave|w/of arthur kil|w/of redwood av|n/of nahant st|n/of arthur kill|s/of arthur kil|s/of country wo	T	92
Cordelia Ave	s/of latourette|e/of latourette	T	24
Cornelia Ave	w/of clove rd|w/of remsen st|s/of remsen st|n/of remsen st	T	9
Cornelia St	s/of remsen st|n/of remsen st|w/of wilson st|e/of minna st|e/of remsen st|s/of minna st	T	16
Cornell Ave	w/of clove rd|s/of clove rd|e/of clove rd	T	44
Cornell Pl		T	9
Cornish St	e/of cleveland|s/of whitman av	T	33
Corona Ave	s/of croft ct	T	64
Correll Ave	e/of arden ave|e/of mallow st|s/of winant ave|w/of gervil st|s/of mallow st|e/of winant ave|w/of mallow st|s/of bombay st|w/of maguire av|n/of winant ave	T	189
Corson Ave	e/of westervelt|w/of daniel low|e/of jersey st|w/of westervelt|e/of westervel|e/of pine st|n/of pine st|w/of westervel	T	351
CORSON AVE		P	13
Cortelyou Ave	e/of lamoka ave|s/of kirby ct|n/of wilson ave	T	97
Cortelyou Pl	w/of lafayette|e/of kirby ct|e/of lafayette a|s/of lafayette|e/of lafayette|w/of lafayette a|n/of lafayette|n/of lafayette a	T	78
CORTLANDT ST		P	4
Cortlandt St	s/of post ave|n/of post ave|w/of post ave	T	84
Cottage Ave	e/of hillside t	T	20
Cottage Pl	s/of bennett st	T	21
COTTER AVE		P	26
Cotter Ave		T	46
Cottonwood Ct		T	6
Coughlan Ave		T	8
Country Woods Ln	w/of tanglewood	T	21
Coursen Ct	n/of warren st	T	7
Coursen Pl		T	33
Court St	e/of van duzer	T	40
Coverly St	e/of tysens ln|n/of tysens ln|w/of belfast av|s/of mobile av	T	9
Covington Cir	w/of powell st	T	51
Cowen Pl	e/of grandview a|w/of post ln|e/of grandview|s/of grandview	T	11
Crabtree Ave	e/of turner st|s/of harrison a|n/of bloomingd|e/of bloomingda|w/of bloomingda|e/of harrison a|n/of other-see|s/of other-see|e/of bloomingd|s/of harris ln|w/of turner st|w/of bloomingd|n/of harris ln|s/of bloomingda|w/of harrison a|w/of harris ln	T	107
Crafton Ave	e/of purdy ave	T	63
Craig Ave	s/of wood ave|s/of hylan blv|e/of main st|e/of lee ave	T	100
CRAIG AVE		P	15
CRAIG AVENUE		S|P	5
Cranford Ave	w/of tysens ln|s/of tysens ln	T	20
Cranford St		T	11
Crescent Ave	n/of bismark av|s/of daniel low|w/of daniel low|e/of daniel low|w/of westervelt	T	91
CRESTON PL		P	5
Crist St	s/of grasmere a|e/of grasmere a	T	4
Crittenden Pl	s/of hatfield pl|s/of charles av|n/of charles ave	T	41
Croak Ave	e/of manor rd|w/of manor rd	T	26
Croft Ct		T	6
CROFT CT		P	4
Croft Pl		T	21
Cromer St	e/of miles ave	T	9
Cromwell Ave	e/of laconia ave|e/of mason ave|s/of n railroad|e/of hylan blvd|s/of hylan blvd|s/of jefferson|n/of hylan blvd|n/of mason ave|n/of jefferson|n/of n railroad	T	233
CROMWELL AVE		P	7
Cross St	e/of bay st|n/of bay st	T	24
Crossfield Ave	s/of berry ave|n/of ladd ave|e/of berry ave|n/of berry ave|s/of token st|e/of token st|n/of token st|n/of watkins av|w/of ladd ave	T	31
Crosshill St	w/of city blvd|e/of city blvd	T	7
CROTON PL	christopher ln	P	7
Crowell Ave		T	40
Crown Ave	w/of evan pl|e/of nippon ave|s/of carlton bl|s/of evan pl|s/of nippon ave	T	153
CROWN AVE		P	4
Crystal Ave	n/of galloway a|n/of auburn ave|n/of riegelman|s/of caswell av	T	50
Cuba Ave	s/of new dorp l|e/of new dorp l|w/of new dorp l	T	87
Cubberly Pl		T	4
Cunard Pl	e/of cedar ter	T	7
Currie Ave		T	11
Curtis Ave	s/of westervel|n/of westervelt|s/of westervelt|e/of manor rd	T	40
Curtis Pl	n/of hamilton av|w/of hamilton av|w/of westervelt|e/of westervelt|e/of hamilton av|s/of hamilton av|s/of westervelt|w/of westervel	T	56
Cypress Ave	s/of victory bl	T	6
CYPRESS LOOP		P	4
DAFFODIL COURT		P	10
DAFFODIL CT		P	12
Daffodil Ct		T	6
Dahlia St	s/of shift pl	T	44
Dale Ave	w/of amboy rd|n/of amboy rd	T	36
Daleham St	e/of greaves av|e/of corbin ave	T	28
Dalemere Rd		T	8
Dalton Ave	w/of tysens ln	T	32
Dana St	w/of metropolita|s/of metropolita|w/of metropolit	T	9
Daniel Low Ter	e/of corson ave|w/of corson ave|w/of fort pl|w/of hamilton av|e/of fort pl|s/of crescent a|e/of hamilton av|n/of corson ave|s/of corson ave|n/of belmont pl|n/of fort hill c|n/of fort pl|s/of hamilton av|s/of fort pl|n/of fort hill	T	311
DANIEL LOW TERRACE		P	5
Darcey Ave	e/of canterbury	T	37
Darlington Ave	s/of vernon ave|w/of vernon ave|n/of huguenot a|n/of vernon ave	T	106
David Pl	e/of pulaski ave|w/of morningsta|n/of pulaski ave|w/of granite a	T	14
David St	s/of forest ave	T	11
Davidson St	s/of grandview|s/of davidson c|n/of andros av|s/of andros ave|n/of mersereau|w/of andros ave|e/of mersereau|e/of davidson c|s/of mersereau|w/of mersereau|e/of andros ave|w/of andros av|w/of davidson c	T	103
DAVIDSON ST	c/o mersereau st|mersereau	P	15
Davis Ave	s/of delafield|w/of castleton|s/of castleton a|n/of castleton|w/of forest ave|e/of forest ave|n/of delafield|s/of forest ave|s/of castleton|n/of forest ave|n/of castleton a|e/of dekay st|s/of delafield p|n/of delafield p|n/of arlington c|s/of henderson a|n/of dekay st|e/of pelton ave|e/of castleton|w/of delafield|s/of harvest av|s/of morrison av	T	536
DAVIS AVE		P	7
DAVIS AVENUE		P	4
DAVIS COURT		P|S	4
Davis Ct		T	6
Dawson Cir	w/of arlene st	T	49
Dawson Ct	e/of arlene st	T	9
Dawson St	e/of martin av|e/of ardmore av|n/of martin ave|w/of ardmore av|e/of martin ave	T	13
De Hart Ave	e/of richmond t	T	161
De Ruyter Pl	w/of van pelt av|s/of maple pky|e/of maple ave	T	21
Deal Ct	n/of dayna dr|n/of mason ave|e/of alberta av|w/of alberta av	T	15
Debbie St		T	44
Decatur Ave		T	9
Decker Ave	e/of palmer av|e/of palmer ave|n/of palmer ave	T	123
Deems Ave	s/of the blvd	T	5
Degroot Pl	w/of bodine st	T	43
DEHART AVE		P	6
Deisius St	s/of luten ave|e/of stecher st|e/of luten ave|w/of kingdom ave|w/of tuckahoe|n/of luten ave|w/of huguenot a|n/of androvette|w/of luten ave|s/of androvette|w/of androvette|e/of huguenot a|w/of tuckahoe a|w/of kingdom a|e/of prall ave	T	72
Dekalb St	e/of oder ave|e/of targee st	T	8
Dekay St	e/of bard ave|w/of n mada ave|e/of n mada ave	T	11
Delafield Ave	w/of broadway|s/of bement ave|w/of bement ave|e/of elizabeth|w/of kissel ave|e/of broadway|w/of raymond pl|w/of n mada ave|e/of kissel ave	T	222
DELAFIELD AVE		P	18
Delafield Pl	e/of bard ave|w/of davis ave|e/of davis ave	T	32
Delaware Ave	s/of laconia ave|w/of laconia ave|s/of laconia av|s/of mason ave|s/of hylan blvd|w/of laconia av|n/of laconia av|e/of laconia av|n/of mason ave|e/of hylan blvd|n/of hylan blvd|s/of richmond rd|n/of laconia ave|s/of richmond r|e/of richmond r|w/of hylan blvd|s/of hylan blv|e/of laconia ave|w/of mason ave|s/of n railroa	T	252
Delaware St	e/of richmond r	T	22
Delford St	s/of roff st|e/of irving pl|n/of roff st|e/of roff st|w/of roff st|s/of irving pl	T	15
Delmar Ave	w/of woodrow rd	T	23
Delmore St	e/of woolley av|e/of crystal ave|e/of crystal av	T	18
Demopolis Ave		T	37
Demorest Ave		T	25
Denker Pl	w/of mcveigh av|w/of mcveigh ave	T	36
Dennis Torricelli Sr	n/of school rd	T	7
Dent Rd		T	9
Denton Pl	e/of hawthorne	T	5
Depew Pl		T	4
Deppe Pl	e/of richmond a	T	56
Derby Ct	n/of haughwout	T	17
Deserre Ave	n/of sheldon a|n/of sheldon av|w/of sinclair a|s/of sinclair|e/of sinclair a|s/of sinclair a|s/of sheldon av	T	33
Detroit Ave		T	21
Devens St	e/of willow rd|w/of levit ave|s/of willowbroo|w/of willowbroo	T	47
Devon Loop	n/of elmwood par|s/of elmwood pa|w/of elmwood par	T	59
Devon Pl		T	4
Dewey Ave	w/of miles ave|w/of graves st	T	30
Dewhurst St	w/of fields ave	T	13
Diaz Pl	n/of weed ave|s/of weed ave	T	17
Diaz St		T	7
Dickie Ave	n/of college a|w/of north ave	T	36
Dierauf St		T	11
Dina Ct	e/of blythe pl	T	25
Dinsmore St	w/of victory bl|s/of victory bl	T	11
Disosway Pl	w/of clove rd|e/of raymond pl|w/of raymond pl|s/of clove rd	T	34
Divine St		T	5
Dix Pl		T	11
Dixon Ave	n/of lake ave|e/of lake ave|e/of trantor pl|e/of simonson a	T	104
Doane Ave	n/of leverett	T	31
DOANE AVE		P	5
Dogwood Dr	s/of yucca dr	T	104
Dogwood Ln		T	4
Domain St	s/of comstock a	T	26
Donald Pl		T	4
Dongan Ave	e/of degroot pl|w/of beechwood p|e/of manor rd|e/of castleton	T	95
DONGAN AVE		P	10
Dongan Hills Ave	s/of n railroad|s/of patterson|e/of richmond r|w/of patterson|s/of richmond r|e/of hylan blvd|n/of richmond r|s/of zoe st|s/of richmond	T	375
DONGAN HILLS AVE		P	11
Dongan St	n/of cary ave|s/of richmond|n/of castleton|n/of degroot pl|s/of castleton|w/of degroot pl|e/of castleton|s/of richmond t|w/of richmond t	T	95
Donley Ave	w/of st johns a	T	36
Donna Ct	w/of elmwood pa|s/of elmwood par	T	15
Dorothea Pl	e/of dale ave	T	20
Dorothy St		T	20
Dorval Ave		T	15
Dorval Pl	w/of annadale r|w/of sunfield a	T	4
Doty Ave	e/of robin rd	T	20
DOTY AVE		P	6
Dover Green		T	61
Downes Ave		T	19
Downey Pl		T	28
Drake Ave		T	40
Draper Pl	s/of travis ave|e/of knapp st	T	23
Dreyer Ave	w/of willowbroo|n/of willowbroo|w/of willowbro	T	84
Driggs St		T	15
Driprock St	n/of post ave|w/of post ave|e/of post ave|s/of post ave	T	12
Drumgoole Rd	n/of genesee a|e/of jefferson b|n/of walcott av|s/of notus ave|e/of albee ave|e/of jefferson|e/of ionia ave	T	30
DRUMGOOLE RD EAST	east of wolcott ave|geneso ave|wolcott ave|notus ave|genesse ave|wolcott av	P	11
DRUMGOOLE ROAD EAST		S	6
Drury Ave	e/of ocean ave|s/of ocean ave|w/of ocean ave|e/of father ca	T	12
Drysdale St	n/of forest hill|s/of jasper st	T	13
Dublin Pl		T	4
Dubois Ave	n/of post ave|e/of post ave|w/of post ave|e/of egbert ave|s/of post ave|w/of egbert ave	T	175
DUBOIS AVE		P	9
Dudley Ave	e/of grand ave|e/of clove rd	T	33
Duer Ave	w/of mcclean av|e/of forest ave	T	5
Duer Ln		T	16
Duke Pl		T	9
DUMONT AVE		P	5
Dumont Ave	n/of hylan blvd	T	6
Dunbar St		T	33
Duncan Rd		T	24
Duncan St		T	5
Dunham St	s/of outerbrid	T	6
Durant Ave	s/of kelvin ave|s/of justin ave|e/of bartow st|e/of keegans l|e/of redgrave a|e/of cleveland|s/of kelvin av|n/of redgrave a|w/of justin ave|e/of kelvin ave|w/of bay ter|w/of hillside t	T	101
Durgess St		T	35
Dutchess Ave		T	7
E Augusta Ave		T	17
E Brandis Ave	e/of armstrong a	T	26
E Broadway		T	43
E Buchanan St	w/of highview a	T	14
E Cheshire Pl	w/of victory bl|e/of victory bl	T	10
E Drumgoole Rd	w/of notus ave|s/of jefferson|s/of monterey a|s/of ionia ave|w/of albert ct|n/of huguenot a|n/of genesee av|n/of vernon ave|n/of wolcott av|s/of notus ave|w/of jefferson b	T	45
E Figurea Ave		T	39
E Macon Ave	e/of armstrong|s/of armstrong	T	19
E Raleigh Ave		T	11
E Reading Ave	e/of armstrong a	T	14
E Scranton Ave		T	16
E Stroud Ave	w/of abingdon a|w/of abingdon	T	59
E Tenafly Ave	s/of s railroad|e/of s railroad	T	5
E/S of CHRISTOPHER L	ane 150' w/o|ane 150' n/o akron s|ane 250' n/o akron s	S	5
E/S of CHRISTOPHER S	treet 50' e/o croton|treet 200' n/o akron|treet 100' e/o akron|treet 50' e/o yona a|treet 50' e/o akron|treet 5' n/o croton|treet 150' n/o akron|treet 200' e/o akron|treet 50' s/o yona a|treet 20' n/o akron|treet 150' e/o akron|treet 5' e/o croton	S	18
E/S of HUGUENOT AVEN	ue 100' n/o sussex a|ue 25' s/o raily cou|ue 50' s/o raily cou|ue 35' n/o raily cou	S	4
E/S of SHARROTTS ROA	d 25' w/o veterans r|d 30' s/o veterans r|d 50' s/o veterans r	S	4
E/S of VETERANS ROAD	east 800' s/o arthu|east 60' n/o wirt a|east 25' s/o woodro|east 100' n/o bloom|east 475' s/o arthu|east 1000' s/o arth|east 500' s/o arthu|west 200' s/o herve|east 30' n/o winant|west 500' s/o arthu|east 100' n/o lucil|west 25' e/o clay p	S	24
Eadie Pl	s/of franklin a	T	8
Eagan Ave		T	14
Earley Ave	n/of delmore s|w/of wade st|n/of wade st	T	6
Eaton Pl	e/of innis st|s/of innis st|e/of richmond a|s/of richmond|n/of innis st|w/of john st|e/of john st	T	61
EATON PLACE		P|S	17
Ebbitts Ave	s/of hylan blv|n/of hett ave|e/of titus ave|s/of hylan blvd|s/of mill rd	T	20
Ebbitts St	n/of weed ave|w/of hylan blvd|s/of hylan blv|e/of hylan blv|s/of roma ave|e/of roma ave|s/of hylan blvd|s/of mill rd	T	113
EBBITTS ST		P	5
EBEY LN	lisa ln	P	6
Ebey Ln	s/of lisa ln|w/of lisa ln|s/of myrna ln|e/of myrna ln	T	24
Ebony St		T	28
Echo Pl		T	35
ECHO PLACE		S	4
Eddy St	w/of victory b|e/of victory bl|s/of victory blv|n/of victory bl|e/of duncan rd|w/of victory bl|s/of victory bl|e/of victory b|s/of howard av|w/of bertha pl|s/of duncan rd|n/of victory blv|s/of victory b	T	101
Edgar Pl	w/of fiedler ave|w/of avon pl	T	7
Edgar Ter	e/of avon pl|s/of fiedler av|w/of avon pl	T	45
Edgegrove Ave	e/of albee ave|e/of belfield	T	142
Edgewater St	e/of hylan blvd|e/of willow ave|e/of front st|e/of bay st|s/of front st|n/of hylan blvd	T	38
Edgewood Rd	e/of lindenwood	T	6
Edinboro Rd		T	6
EDISON ST		P	5
Edison St	e/of fremont av|n/of fremont av|w/of fremont st|s/of fremont av|w/of bancroft a|w/of new dorp l|s/of fremont ave|w/of midland av|e/of new dorp l|e/of new dorp ln|w/of bancroft av|e/of bache ave|n/of new dorp ln	T	160
Edith Ave	e/of irvington|s/of huguenot a|w/of huguenot av|w/of huguenot a|n/of huguenot av	T	13
EDWARD CURRY	glen st|gulf ave|glen	P	7
EDWARD CURRY BLVD	glen st|gulf ave|f/o gulf ave|guld ave	P	16
Egbert Ave	e/of greenleaf|w/of mundy ave	T	110
Egbert Pl	n/of fingerboa	T	12
Egmont Pl	e/of hamilton av|s/of hamilton av	T	29
EL CAMINO LOOP		P	16
Elbe Ave	n/of clove rd|e/of clove rd|s/of steuben st|s/of manton pl	T	62
Eldridge Ave	s/of forest ave	T	42
Elias Pl		T	13
Elie Ct		T	11
Elizabeth Ave	s/of delafield	T	25
Elizabeth Rd		T	6
Elizabeth St	n/of forest ave|n/of cary ave|s/of forest ave|s/of cary ave|s/of delafield|s/of castleton|n/of delafield|w/of cary ave	T	102
Elkhart St	e/of greaves av|w/of greaves av	T	42
ELLICOTT PLACE		S	4
Ellington St	e/of targee st|n/of targee st	T	8
Ellis St	e/of amboy rd|n/of arthur kil|e/of arthur kil	T	19
Ellsworth Ave	e/of ionia ave	T	13
Ellsworth Pl	e/of fairview a	T	20
Elm St	s/of castleton a|w/of richmond t|s/of richmond t|s/of castleton|e/of castleton|e/of richmond t	T	157
Elmbank St	e/of harold ave|s/of woods of a|e/of arden ave	T	11
Elmira Ave		T	4
Elmira St	e/of guyon ave|w/of guyon ave	T	8
Elmwood Ave	e/of sycamore s|n/of sycamore s	T	7
Elmwood Park Dr	s/of marsh ave|e/of devon loop|e/of marsh ave|s/of devon loop|w/of devon loop	T	34
Elson Ct	n/of regis dr|s/of regis dr|e/of regis dr|n/of jules dr|w/of ada dr|n/of ada dr|w/of regis dr|s/of ada dr|e/of ada dr|s/of jules dr|e/of jules dr	T	69
ELSON ST		P	4
Elson St	s/of gauldy ave	T	64
Eltinge St		T	9
Eltingville Blvd	n/of richmond a|n/of genesee ave|n/of acorn ct|e/of richmond a|w/of richmond a|s/of wilson ave|e/of richmond|w/of richmond av	T	567
Elverton Ave	s/of arthur kil|n/of leverett|s/of leverett a|n/of leverett a	T	95
Elvin St	e/of garden st	T	95
Elwood Ave	e/of rockne st	T	27
Elwood Pl	w/of walbrooke|w/of hart blvd|w/of randall av|w/of randall ave	T	25
Ely Ave		T	8
Ely St	s/of brighton a|e/of brighton a	T	46
Emerson Ct		T	9
Emmet Ave	e/of n railroad	T	23
Endor Ave		T	18
Engert St		T	15
ENGLEWOOD AVE		P	4
Englewood Ave		T	40
Erastina Pl		T	44
Erie St	s/of hallister|s/of dunham st	T	4
Errington Pl		T	17
Escanaba Ave		T	16
ESSEX DR		P	8
Essex Dr	s/of wellington|n/of wellingto|n/of westport|s/of westport|w/of richmond h|s/of richmond h|e/of richmond h|w/of wellingto|s/of other-see|e/of westport	T	352
ESSEX DRIVE		P	10
Estelle Pl	s/of page ave	T	6
Eton Pl	s/of richmond a|n/of innis st|e/of richmond a|e/of richmond	T	32
Eunice Pl	s/of wilcox st|e/of forest ave	T	17
Eva Ave		T	30
Evan Pl		T	7
Evans St		T	11
Evelyn Pl	w/of home ave|w/of bay st	T	20
Everett Ave		T	9
Evergreen Ave	n/of hylan blvd|s/of remsen st|s/of hylan blvd	T	65
EVERGREEN AVE		P	4
Evergreen St	e/of redwood ave	T	34
Everton Ave	e/of woodrow rd|n/of woodrow rd|w/of woodrow rd	T	30
Excelsior Ave	e/of woodvale|e/of woodvale a	T	18
Exeter St	w/of gibson av|s/of gibson av	T	25
Eylandt St	s/of androvette|s/of chisholm s|n/of luten ave|w/of luten ave|s/of tuckahoe|s/of tuckahoe a|e/of huguenot av|n/of chisholm s|w/of chisholm|w/of chisholm st|w/of tuckahoe a|n/of tuckahoe a|s/of chisholm|s/of huguenot av|e/of chisholm s|s/of luten ave|e/of luten ave|e/of chisholm|n/of huguenot a|n/of chisholm st|w/of androvette|e/of chisholm st|e/of tuckahoe a	T	150
EYLANDT ST	lipscott ave	P	4
Faber St	e/of castleton|w/of castleton|n/of grove ave|e/of grove ave|n/of harrison|e/of richmond t|w/of harrison a|w/of port richm|e/of harrison av|n/of harrison a|s/of harrison|s/of richmond t|w/of grove ave|s/of harrison a|n/of castleton a|e/of harrison a|n/of larkin st|w/of larkin st|n/of castleton|s/of castleton|w/of richmond t|s/of chisholm	T	165
FABER ST		P	4
Fabian St	e/of mosely ave|w/of mosely av|e/of eagan ave	T	19
Fahy Ave	w/of felton st|n/of caswell ln|n/of lamberts l	T	26
Fairbanks Ave		T	76
Fairfield St	w/of greaves av|s/of greaves av|e/of greaves a|w/of greaves ave|e/of greaves ave|e/of miles ave|e/of greaves av	T	75
Fairlawn Ave	e/of hylan blv|s/of fairlawn l	T	5
Fairview Ave	e/of sanford p|w/of utter ave|n/of victory bl|n/of potter ave|s/of victory blv|n/of rice ave	T	43
FAIRWAY AVE		P	8
Fairway Ave	s/of park hill|n/of victory bl|w/of park hill|w/of osgood ave|n/of osgood ave|n/of park hill|e/of osgood ave	T	98
FAIRWAY AVENUE		P|S	8
Falcon Ave	w/of tysens ln|e/of guyon ave	T	40
Fancher Pl	w/of northfield	T	29
FANNING ST		P	7
Fanning St	n/of holden blvd|s/of s gannon av|s/of holden blv|w/of westwood a	T	114
Farraday St	s/of madison av|s/of w caswell a|n/of w caswell|n/of willow rd|e/of w caswell|s/of w caswell|s/of madison ave|n/of w caswell a	T	41
Farragut Ave	s/of ada dr|n/of ada dr	T	41
FATHER CAP BLVD		P	12
FATHER CAPODANNO	sand lane|buel|sand ave	P	6
Father Capodanno Blv	w/of sand ln|e/of sand ln|n/of seaview av|e/of seaview av|e/of buel ave|n/of linda ave|e/of jefferson|s/of seaview a|n/of jefferson|n/of seneca loo|e/of linda ave|s/of sand ln|s/of naughton a	T	150
FATHER CAPODANNO BLV	seaview ave|lot s	P	72
FATHER CAPODANNO BOU	levard	S	7
Fayette Ave	e/of parkinson a|e/of parkinson|e/of woodlawn a|w/of parkinson|w/of parkinson a|s/of parkinson a	T	37
Federal Pl	e/of richmond|s/of richmond te|s/of richmond|w/of richmond te|e/of richmond t|s/of richmond t|n/of richmond t|w/of richmond t	T	132
Felton St	s/of gauldy ave|n/of aye ct|s/of aye ct|n/of caswell ln|s/of caswell ln|n/of lamberts l|e/of gauldy ave|e/of caswell ln|n/of gauldy ave|n/of leigh ave|s/of leigh ave|s/of fahy ave|w/of fahy ave	T	44
Fenway Cir	s/of barlow ave|e/of barlow ave|n/of barlow av|s/of barlow av	T	31
Fern Ave		T	15
Ferndale Ave	s/of rockland a|e/of saxon ave|s/of saxon ave|w/of saxon ave	T	16
FIEDLER AVE		P	4
Fiedler Ave	e/of victory bl|s/of victory bl	T	19
Field St	s/of colonial av|w/of colonial a|e/of forest hill	T	26
Fields Ave		T	23
Fieldstone Rd		T	36
Fieldway Ave	s/of greencroft	T	17
Figurea Ave	w/of wainwright	T	58
Fillat St		T	22
Fillmore Ave	w/of franklin a|s/of willowbrook	T	33
Fillmore St	w/of york ter|n/of franklin a|n/of tysen st|e/of franklin av|w/of clinton ave|w/of tysen st|w/of clinton av|e/of lafayette|n/of clinton a|e/of tysen st|s/of minerva pl	T	206
FILLMORE ST		P	8
FILLMORE STREET		S|P	6
Fine Blvd	w/of melhorn rd	T	7
Fingal St		T	4
Fingerboard Rd	s/of hillbrook d|s/of hillbrook|e/of wilton ct	T	65
FINGERBOARD RD		P	19
FINGERBOARD ROAD		P|S	9
Finlay Ave	e/of woodvale a|e/of hylan blvd	T	36
Finlay St	e/of summit rd|s/of amboy rd|e/of amboy rd	T	34
Finley Ave	w/of ebbitts st|w/of tysens ln	T	36
Firth Rd	s/of merrill av|e/of merrill av	T	34
Fisher Ave	n/of amboy rd|s/of arthur kil|n/of arthur kil	T	36
Fletcher St	e/of st marys a	T	8
Flint St		T	8
Florence Pl	w/of seguine av|w/of seguine a|n/of seguine av	T	23
Florence St		T	10
Florida Ave	n/of mcclean av|w/of mcclean av|n/of mcclean ave|w/of mcclean ave	T	34
Flower Ave	w/of richard av	T	8
Floyd St	e/of dubois av|s/of dubois ave|e/of dubois ave	T	36
Foch Ave	w/of mallory av|n/of linwood av|e/of lamport blv	T	47
Foote Ave	s/of clove rd	T	47
Ford Pl		T	13
Forest Ave	n/of morrow st|w/of mundy ave|n/of duer ln|n/of elizabeth s|w/of metropolit|w/of victory bl|n/of victory bl|e/of van pelt a|w/of amity pl|w/of manor rd|w/of walbrooke|e/of clove rd|s/of goethals|e/of pelton ave|e/of mundy ave|w/of lawrence av|e/of sharon ave|w/of lawrence a|e/of lawrence|w/of dwarf st|s/of n burgher|w/of kissel ave|w/of willow rd|e/of bard ave|e/of elizabeth|w/of oakland av|w/of pelton ave|n/of goethals r|e/of duer ln|w/of oakland ave|w/of bard ave|s/of van pelt a|w/of duer ln|e/of oakland av|w/of n burgher|w/of elizabeth|w/of bement ave|w/of eldridge a|s/of pelton ave|s/of lake ave|s/of bertha pl|s/of elizabeth|w/of oakdale av|s/of elizabeth s|w/of brighton a|s/of oakland av|e/of dubois ave|e/of morrow st	T	4047
FOREST AVE	clove rd|van name ave|goethals rd n|gulf ave	P	53
FOREST AVENUE		P|S	27
Forest Ct	w/of union ave|w/of bush ave|e/of union ave|s/of union ave	T	13
FOREST GREEN		P	14
Forest Green	e/of arden ave	T	39
Forest Hill Rd	e/of pilcher st|s/of norwich st|w/of stone ln|s/of leason pl|e/of yukon ave|n/of uxbridge s|s/of willowbro|e/of harold st|w/of rumson rd|e/of platinum a|n/of boone st|s/of rumson rd|e/of rumson rd	T	51
Forest Rd	n/of richmond	T	18
Forest St	w/of richmond a|n/of richmond a|e/of arlene st	T	48
Forrestal Ave		T	21
Forrestal Ct		T	9
Fort Hill Cir	n/of daniel low|s/of daniel low|w/of daniel low	T	94
Fort Pl	e/of sherman av|w/of daniel low|s/of daniel low|e/of daniel low|n/of daniel low	T	158
Foster Ave	e/of lamont ave	T	4
Foster Rd	n/of ramapo ave	T	6
FOSTER RD		P	4
Fox Hill Ter	s/of virginia a|n/of virginia av|n/of maryland a|s/of hylan blvd|s/of virginia|w/of virginia a|s/of hylan blv|e/of hylan blv	T	33
Foxholm St		T	13
FR CAPODANNO BLVD		P	32
FRANCESCA LANE		S	5
Francesca Ln		T	6
Francine Ct	e/of amboy rd|e/of behan ct	T	11
Franklin Ave	e/of van buren|w/of arnold st|w/of richmond t|e/of prospect a|w/of prospect a|s/of prospect a|e/of eadie pl|w/of van buren s|e/of prospect av|n/of van buren|s/of richmond t|e/of norwalk av	T	61
Franklin Pl	n/of norwalk a	T	14
Fraser St		T	42
Freeborn St	w/of mapleton a|s/of midland a|e/of greeley av|w/of midland av|n/of lincoln av|w/of lincoln ave	T	67
Freedom Ave	s/of rivington|s/of amsterdam|e/of amsterdam|n/of rivington a	T	157
Fremont Ave	n/of brook st	T	52
Fremont St	s/of corson av|e/of victory b|n/of brook st|n/of corson ave|s/of brook st|s/of corson ave|e/of corson ave	T	22
FRONT ST	edgewater|water st|edgewater plz|canal st	P	27
Front St	n/of wave st|s/of wave st|n/of water st|n/of canal st|s/of prospect|e/of water st|n/of prospect s|s/of prospect s|s/of edgewater|s/of canal st|w/of wave st|pier  7th|w/of water st|n/of prospect a|n/of prospect|n/of prospect st|w/of bay st	T	1224
FRONT STREET		S|P	60
FT CAPODANNO BLVD		P	5
Fuller Ct		T	4
Fulton St	s/of warren st	T	42
FULTON STREET		S|P	8
Furman St		T	6
Furness Pl		T	29
Gadsen Pl	s/of travis ave|n/of travis ave|e/of travis ave|w/of travis ave	T	61
Galloway Ave	e/of marianne|w/of marianne s	T	47
Gannon Ave	e/of willowbrook|e/of quinlan ave|w/of gansevoort|e/of fanning st|e/of woodward a	T	15
Gansevoort Blvd	n/of brielle a|n/of holden blv|n/of brielle av|w/of brielle av|e/of portage av|s/of brielle ave|n/of portage ave|e/of brielle av|s/of portage ave|n/of brielle ave	T	153
GANSEVOORT BLVD		P	10
Garden St		T	6
Garfield Ave	e/of tompkins a|e/of fillmore pl	T	22
Garibaldi Ave	w/of cedar grov	T	10
Garretson Ave	s/of hylan blvd|e/of hylan blvd|w/of richmond r|s/of mason ave|n/of jefferson s|e/of mason ave|n/of mason ave|s/of richmond r|e/of richmond r|s/of richmond rd|n/of richmond r|w/of plattsburg|w/of mason ave	T	249
GARRETSON AVE		P	8
Garrison Ave	s/of livermore|w/of livermore|n/of livermore a	T	13
GARY CT		P	5
Gary Ct		T	95
Gary Pl		T	34
Gary St	w/of woodrow rd|e/of kenilworth	T	30
GATEWAY DRIVE		P	4
GATON STREET		S	10
Gauldy Ave	n/of leigh ave|w/of longdale st|w/of bee ct|e/of longdale st	T	50
Gaynor St	s/of herrick ave|s/of pitney ave|n/of herrick ave|e/of churchill a|n/of pitney ave|w/of herrick ave|e/of churchill	T	42
Geldner Ave		T	24
Genesee Ave	w/of armstrong|e/of cortelyou a|s/of wainwright|n/of wainwright|w/of richmond|e/of wainwright|e/of ridgewood|e/of getz ave|w/of richmond a|w/of wainwright|n/of getz ave|w/of eltingvill|w/of ridgewood a|w/of ridgewood|e/of armstrong|w/of armstrong a	T	125
Genesee St	e/of clove rd	T	4
George St	e/of sprague ave|e/of sleight ave	T	11
Gervil St	n/of correll a|n/of correll av	T	36
Getz Ave	s/of arthur kil|s/of arthur ki|e/of arthur ki|n/of gurley ave|n/of gurley av|e/of arthur kil	T	59
Geyser Dr		T	17
GEYSER DR		P	11
GEYSER DRIVE		S|P	5
Gibson Ave		T	20
Giffords Glen	w/of nelson ave|e/of nolan ave|w/of nolan ave|s/of nelson ave|w/of nelson av|e/of lindenwoo|w/of lindenwood|e/of nelson ave|n/of nelson ave|s/of nolan ave	T	24
Giffords Ln	s/of jumel st|s/of brower ct|e/of jumel st|n/of hereford s	T	237
Gilbert Pl	w/of bedell st	T	17
Gilbert St	n/of clarke ave|e/of clarke ave	T	18
Giles Pl	e/of grasmere c|s/of grasmere a|n/of grasmere a|e/of grasmere av	T	9
Gilroy St		T	18
Gina Ct	lowell av	T	4
Gladwin St		T	6
Glascoe Ave	n/of waters ave	T	17
Glen Ave		T	47
Glen St	s/of melvin av|n/of victory bl|e/of victory bl|w/of brighton a|s/of victory bl|s/of melvin ave|w/of victory b|n/of wild ave|w/of victory bl|n/of victory b|e/of edward cu	T	86
GLEN ST	south ave|edward curry blvd|victory blvd|edward curry|edward curry ave|melvin ave	P	20
Glendale Ave		T	5
Glenn Rd	w/of slayton av	T	15
Glenwood Ave	e/of clove rd|w/of clove rd	T	48
Glenwood Pl	s/of broadway|w/of broadway	T	30
GLOBE AVE	lamberts	P	4
Globe Ave	e/of lamberts l|s/of lamberts	T	9
Glover St	s/of hylan blvd|e/of hylan blvd	T	48
Goethals Rd	w/of jules dr|s/of domain st|e/of forest av|e/of jules dr|goethals rd n|goethala rd n|w/of forest av|notrh|north|s/of south ave|s/of jules dr|e/of cooke st|e/of south ave|goethals road north|goethals road n|e/of forest ave|w/of south ave|s/of regal walk	T	94
GOETHALS RD N	south ave|forest ave	P	52
GOETHALS RD NORTH	forest ave|south ave	P	17
GOETHALS ROAD NORTH	forest ave|south ave	S|P	125
Goff Ave	e/of vogel pl	T	4
Gold Ave		T	23
Goller Pl	s/of croft pl	T	28
Goodall St	e/of hylan blvd|e/of tennyson d|s/of hylan blvd	T	53
GOODALL STREET		P	4
Goodwin Ave	e/of jewett av	T	11
Gordon St	warren st|w/of broad st|n/of osgood ave|n/of broad st|e/of broad st	T	348
GORDON ST		P	24
GORDON STREET		P|S	12
Governor Rd	e/of manor rd|w/of beechwood p	T	23
Gower St	s/of portage ave|w/of n gannon a|n/of n gannon a|s/of n gannon a	T	109
Grace Ct	e/of henderson|s/of henderson|n/of henderson	T	11
Grace Rd	s/of henderson	T	4
Grafe St	e/of azalea ct|s/of arrowood c|e/of rossville|w/of arrowood|n/of azalea ct|s/of azalea ct|w/of azalea ct|w/of rossville	T	48
Graham Ave	s/of grimsby st|s/of sommer ave|s/of fieldstone|n/of fieldstone|e/of fieldston	T	85
Graham Blvd	w/of father cap|s/of grimsby s|s/of grimsby st	T	14
Grand Ave	s/of foote ave|n/of foote ave|n/of howard av	T	20
GRANDVIEW AVE		P	22
Grandview Ave	w/of netherlan|s/of forest ave|e/of forest av|n/of forest av|e/of brabant st|w/of forest ave|s/of christopher|s/of cowen pl	T	340
Grandview Ter	e/of nelson ave|s/of cleveland|w/of hillside t|s/of hillside t|w/of cleveland	T	39
Granite Ave	w/of walker st|n/of lasalle s|e/of richmond t|s/of richmond|w/of richmond t|e/of lasalle s|s/of lasalle s|n/of richmond a|e/of dixon ave|e/of walker st|n/of ronald ave|e/of ronald ave|w/of lasalle s|e/of lasalle st	T	317
GRANITE AVE		P	9
GRANITE AVENUE		S	14
Grant Pl	s/of midland av	T	33
Grant St	w/of van duzer|e/of st pauls a|e/of van duzer|w/of van duzer s|s/of van duzer	T	51
Grantwood Ave	s/of tryon ave|e/of tryon ave|e/of shotwell a	T	62
Grasmere Ave	e/of w fingerbo	T	25
Graves St	n/of holden blvd|s/of westwood a|n/of brielle av|n/of portage a|s/of portage ave	T	96
Gray St	n/of hudson st|s/of gordon st|e/of gordon st	T	11
Grayson St		T	33
Great Kills Municipa		T	70
Great Kills Rd	e/of mansion av|n/of mansion ave	T	57
Greaves Ave	s/of barlow ave|n/of leverett|e/of daleham s|n/of elkhart s|s/of fairfield s|w/of elkhart st|n/of elkhart st|s/of barlow av|w/of belknap st|n/of fairfield|e/of fairfield s|n/of fairfield s|w/of fairfield|s/of elkhart st|s/of elkhart s	T	52
Greeley Ave	w/of kiswick st|e/of clawson st|e/of patterson|n/of rudyard st|s/of richmond r	T	80
GREELEY AVE		P	7
Green St	e/of bement ave|w/of bement ave	T	148
Green Valley Rd	e/of victoria rd|w/of manchester	T	95
GREEN VALLEY RD		P	19
GREEN VALLEY ROAD		P	4
Greencroft Ave	e/of egbert ave|e/of keegans ln|w/of keegans ln|e/of post ave|e/of redgrave av|w/of ainsworth a	T	70
Greenfield Ave	w/of osgood ave|e/of osgood ave|e/of tompkins|s/of bay st|e/of opus ct|s/of osgood ave	T	31
Greenleaf Ave	w/of delafield|n/of egbert pl|s/of marion st|w/of post ave|s/of post ave|s/of forest ave|e/of post ave|s/of delafield	T	107
GREENLEAF AVE		P	11
Greenwood Ave	n/of forest ave	T	9
Gregg Pl	w/of hart blvd|n/of hart blvd|e/of hart blvd|w/of walbrooke|e/of walbrooke	T	22
Gridley Ave		T	65
Grimsby St	w/of lincoln av|w/of bedford av|w/of midland av|n/of midland av	T	71
Grissom Ave		T	12
Groton St	s/of hylan blvd	T	19
Grove Ave	w/of port richm|w/of harrison a|e/of port richm|w/of maple ave|e/of maple ave|s/of port richm|e/of faber st|w/of port rich	T	76
GROVE AVE		P	4
Grove Pl	s/of castleton a	T	24
Grove St	w/of port richm|e/of maple ave|s/of court st|e/of port richm|e/of gordon st|s/of gordon st|w/of court st	T	24
Grymes Hill Rd	e/of duncan rd	T	10
Guilford St	w/of lily pond a|e/of ocean ave	T	21
Gulf Ave	s/of western av	T	240
GULF AVE	forest western|forest ave|edward curry blvd|bloomfield ave|edward curry ave	P	99
GULF AVENUE		S|P	15
Gunton Pl	e/of rossville	T	17
Gurdon St	w/of woolley a	T	5
Gurley Ave	w/of abingdon|e/of doane ave|s/of richmond a|e/of elverton a|w/of eltingvill|n/of richmond a|w/of getz ave|w/of eltingville|e/of bartlett a|e/of brookfiel|w/of brookfield|s/of getz ave|e/of bartlett av|e/of brookfield|w/of richmond a|e/of eltingvil|e/of colon ave|e/of richmond av|w/of eltingvil|s/of eltingvill|n/of brookfield|e/of eltingvill|e/of richmond a|w/of bartlett a|w/of doane ave	T	96
GURLEY AVE		P	6
Guyon Ave	e/of leeds st|n/of hylan blv|n/of hylan blvd|s/of hylan blvd|n/of n railroad|n/of pendale st|n/of medina st|e/of n railroad|w/of medina st|e/of melba st	T	292
Hagaman Pl	e/of decker av	T	29
Hale St		T	9
Hales Ave		T	24
Hall Ave		T	52
Hallister St		T	18
Halpin Ave		T	28
Hamden Ave	s/of hylan blv|s/of hylan blvd	T	83
Hamilton Ave	w/of vanderbilt|e/of van duzer|e/of egmont pl|w/of curtis pl|e/of daniel low|e/of curtis pl|s/of westervel|s/of curtis pl|n/of daniel low|s/of daniel low|s/of st marks pl|n/of curtis pl|w/of daniel low|w/of ebbitts st|e/of st marks p	T	786
HAMILTON AVE		P	30
Hamilton St	w/of vanderbilt	T	113
Hamlin Pl	n/of forest av|e/of forest ave|s/of forest ave|e/of haughwout|n/of forest ave|s/of haughwout	T	36
Hammock Ln		T	24
Hampton Green	n/of regent cir|w/of regent cir|n/of princeton	T	47
HAMPTON GREEN		P	20
Hampton Pl	s/of wirt ave|n/of wirt ave|n/of ivy ct|w/of wirt ave|e/of meadow ct|s/of balsam pl	T	29
Hancock St	e/of garretson a|e/of cromwell av|n/of garretson|w/of cromwell av|e/of seaview av|e/of garretson|w/of garretson	T	57
Hank Pl		T	26
Hannah St	w/of st pauls a|e/of st pauls a	T	16
Hanover Ave	s/of palma dr|n/of palma dr|w/of palma dr|n/of narrows rd|e/of palma dr|e/of narrows rd	T	75
HARBOR RD	leyden	P	18
Harbor Rd	n/of leyden av|s/of richmond t|s/of forest ave	T	220
HARBOR ROAD		S|P	4
Harbor View Ct	n/of castleton a|s/of castleton	T	14
Hardy St	w/of irving pl|n/of roff st|s/of prince st|w/of roff st|s/of roff st|n/of irving pl|e/of roff st|s/of irving pl|s/of irvington|e/of irving pl|e/of prince st	T	75
Harold Ave	n/of eylandt s|e/of joseph ave|e/of gansevoort|n/of tallman st|s/of hylan blvd	T	45
Harold St	w/of bradley ave|s/of fanning st|s/of mountainvi|w/of wellbrook|e/of bradley av|e/of bradley a|w/of bradley av	T	93
HAROLD STREET		P|S	6
Harris Ave		T	16
Harris Ln	n/of bloomingd	T	13
Harrison Ave	e/of port richm|w/of faber st|w/of port richmo|w/of nicholas av|e/of faber st|w/of maple ave|w/of port richm	T	126
HARRISON AVE	sharpe ave	P	13
Harrison St	e/of brownell st|e/of quinn st|s/of brownell st|s/of quinn st|w/of quinn st	T	82
Hart Ave		T	18
Hart Blvd	w/of forest ave|s/of forest ave|n/of revere st|n/of forest ave	T	119
Hart Pl		T	7
Hartford Ave	n/of whitewood	T	17
Hartford St	n/of nelson ave|w/of port richm|e/of nelson ave	T	36
Harvard Ave	s/of prospect a|s/of park pl	T	41
Harvest Ave	s/of lawrence a|w/of bard ave|e/of oakland av|w/of lawrence a|w/of davis ave	T	27
Harvey Ave	n/of caswell av|e/of caswell av|s/of caswell av	T	30
Harvey St	e/of brown pl	T	15
HASTINGS ST		P	4
Hastings St	n/of mcclean ave|n/of mcclean av|s/of mcclean av|e/of narrows rd|w/of mcclean av|s/of narrows rd	T	55
HASTINGS STREET		P|S	7
Hatfield Pl	e/of treadwell|e/of nicholas a|w/of nicholas a|s/of nicholas|w/of heberton a|w/of treadwell|e/of port richm	T	97
HATFIELD PL	heberton	P	10
Haughwout Ave	e/of jewett ave|s/of jewett ave	T	33
Haven Ave		T	50
Haven Espl	n/of castleton|w/of castleton|s/of castleton a|s/of castleton|w/of castleton a|e/of castleton	T	171
Havenwood Rd	s/of silver lak|s/of silver lake|w/of castleton|s/of castleton|n/of castleton|n/of castleton a|n/of forest ave|e/of silver lak	T	51
HAVENWOOD RD	forest ave	P	5
Hawley Ave	w/of west ter	T	11
Hawthorne Ave	e/of auburn ave|n/of watchogue|e/of dryden ct	T	56
Hay St	s/of targee st|n/of oder ave|w/of britton av|e/of oder ave|e/of targee st	T	8
Heaney Ave	s/of forest ave|n/of wilcox st	T	37
Heberton Ave	e/of richmond te|e/of albion pl|s/of vreeland st|n/of post ave|e/of richmond t|w/of bennett st|w/of richmond t|w/of richmond te|s/of richmond t|n/of anderson a|s/of post ave|n/of richmond t	T	287
HEBERTON AVE	vreeland ave	P	44
HEBERTON AVENUE		S	9
Hecker St	w/of lenhart st|n/of lenhart st|s/of lenhart st|n/of craig ave|w/of craig ave|e/of lenhart st	T	66
Heenan Ave	w/of ramona av|s/of lamont ave	T	12
Heffernan St		T	5
Heinz Ave	s/of hylan blvd|e/of hylan blvd	T	38
Helene Ct		T	13
Hemlock St	w/of mason blvd	T	16
Hempstead Ave		T	14
HEMPSTEAD AVENUE		P	4
Henderson Ave	s/of cassidy p|s/of lafayette a|w/of alaska st|n/of cassidy pl|w/of lafayette|e/of alaska st|s/of bement ave|s/of n burgher|n/of clinton av|e/of lafayette|e/of bement ave|e/of lafayette a|s/of lafayette|e/of n burgher|s/of alaska st|s/of chappell s|e/of chappell s|w/of bement av|n/of davis ave|w/of broadway|s/of caldera pl|e/of clinton av|w/of clinton ave|w/of lafayette a|s/of broadway|e/of davis ave|w/of bement ave	T	439
HENDERSON AVE	kirby ct	P	20
HENDRICKS AVE		P	10
Hendricks Ave	s/of sherman ave|s/of lafayette|e/of westervelt|s/of westervelt|s/of sherman av|e/of sherman av|e/of sherman ave|s/of sherman a|n/of sherman av|s/of fort hill|w/of sherman av	T	162
Henry Pl	n/of alter ave|w/of atlantic a|e/of atlantic a|e/of raritan av|w/of garretson|w/of cromwell av|w/of cromwell a|w/of raritan av|w/of cromwell|n/of raritan av|w/of crowell av|e/of alter ave|e/of delaware a	T	57
Herbert St		T	26
Herrick Ave	s/of sherman av|w/of sherman av|w/of bloomingdal|s/of gladwin s|n/of gladwin s|e/of gaynor st|e/of gladwin st|s/of gladwin a|n/of gaynor st	T	63
Hett Ave	s/of ebbitts st|w/of tysens ln|w/of ebbitts st|e/of tysens ln	T	57
Heusden St	w/of simonson a|e/of simonson a|e/of van pelt a	T	41
Hewitt Ave	s/of milford dr	T	41
HEWITT AVE		P	5
Hickory Ave	s/of hylan blvd|n/of foch ave|w/of foch ave	T	95
Highland Ave	e/of howard ave	T	51
Highland Ln	e/of armstrong a|e/of armstrong	T	9
Highland Rd	w/of dent rd	T	18
Highview Ave	s/of fillmore s|e/of fillmore st	T	21
HILL ST		P	16
Hill St	n/of gordon st|e/of warren st|n/of warren st|w/of warren st|s/of warren st	T	590
HILL STREET		P	5
Hillcrest Ave	s/of lindenwood	T	48
Hillcrest St		T	16
Hillcrest Ter		T	4
Hillis St	n/of amboy rd|s/of amboy rd	T	10
Hillman Ave	w/of richmond av	T	72
Hillside Ave	e/of targee st	T	21
Hillside Ter	w/of amboy rd|s/of durant ave	T	102
Hilltop Rd	n/of ridgecrest	T	4
Hinton St	w/of kenilworth	T	18
Hitchcock Ave		T	17
Hodges Pl	s/of victory bl|n/of victory bl	T	54
Holbernt Ct		T	16
Holcomb Ave		T	31
Holden Blvd	e/of livingston|e/of wellbrook|e/of graves st|e/of bradley av	T	43
Holdridge Ave	s/of kinghorn s|n/of ravenna s	T	38
Holgate St	e/of hawthorne|e/of willowbrook	T	11
HOLIDAY WAY		S	4
Holland Ave	w/of richmond t|n/of richmond t|s/of richmond t|e/of benjamin p|e/of richmond t|w/of richmond te	T	326
HOLLAND AVE		P	26
Holly Ave	e/of oakdale st|w/of oakdale st|s/of richmond t	T	52
Holly Pl	s/of grace rd	T	4
Holly St	n/of vista ave	T	12
Holten Ave	s/of norma pl|n/of armour pl|w/of bradley av|w/of keating st	T	20
Holton Ave		T	8
Home Ave		T	6
Home Pl	e/of evelyn pl	T	79
Homestead Ave	e/of port richm|n/of port richmo	T	28
Hooker Pl	w/of nicholas a|s/of trantor pl|e/of pulaski ave|w/of nicholas av|e/of laforge pl|w/of trantor pl|w/of morningstar|n/of trantor pl|n/of nicholas av|e/of trantor pl	T	134
Hooper Ave	w/of buffalo st|e/of buffalo s|e/of buffalo st	T	23
Hope Ave		T	50
Hopkins Ave	n/of hylan blvd|s/of thollen st|e/of block st|s/of block st|n/of block st|n/of hylan blv	T	32
Hopping Ave		T	18
Houseman Ave	w/of richmond t|w/of wright ave|s/of richmond t	T	57
Houston St	w/of willowbrook	T	24
HOWARD AVE		P	7
Howard Ave	e/of wagner col|e/of signal hil|w/of wagner col|e/of campus rd|w/of campus rd|n/of wagner col|s/of arlo rd|n/of martha st|w/of hillside a|n/of seth ct|e/of seth ct|e/of highland a|s/of campus rd|s/of signal hil|s/of hillside|s/of hillside a|n/of campus rd|s/of signal hi|e/of arlo rd|e/of hillside av|n/of signs rd	T	272
HOWARD AVENUE		S|P	12
Howard Ct		T	7
Howe St	w/of bement ave	T	4
Howton Ave	e/of giffords l	T	12
Hoyt Ave	s/of castleton|s/of forest ave|n/of forest ave|e/of forest ave	T	137
Hudson Pl	n/of westbrook|s/of westbrook a|s/of westbrook|s/of wenlock st|n/of westbrook a	T	20
Hudson St		T	20
Huguenot Ave	e/of bloomingda|e/of sussex gre|w/of avon green|n/of sussex gre|n/of arthur kil|w/of castor pl|e/of hylan blv|s/of sussex gre|s/of edith ave|e/of raily ct|e/of cody pl|w/of hylan blv|n/of avon gree|s/of avon green|n/of edith ave|w/of arthur ki|n/of woodrow rd|w/of chester av|s/of arthur kil|w/of avon gree|n/of avon green|e/of e drumgool|n/of amboy rd|s/of billings st|n/of sussex gr|e/of avon green|n/of rumba pl|e/of jansen st	T	184
HUGUENOT AVE		P	9
HUGUENOT AVENUE		S	4
Hull Ave	e/of richmond r|s/of hylan blvd|e/of hylan blvd|n/of hylan blvd|w/of hylan blvd	T	81
Humbert St	e/of sand ln	T	8
Hunter Ave	n/of hylan blvd|w/of moreland s|w/of father cap|s/of hylan blvd|s/of kiswick st|s/of kiswick s|n/of father cap|e/of kiswick st	T	89
Hunter Pl		T	18
Hunter St	s/of spring st	T	7
Hunton St	e/of richmond r|w/of richmond r	T	9
Hurlbert St		T	39
Huron Pl	w/of metropolit	T	10
Hurst St	e/of jewett ave	T	4
Husson St	w/of jefferson a|e/of liberty ave|e/of jefferson|n/of jefferson|w/of jefferson	T	62
Hyatt St	w/of central ave|e/of st marks pl|e/of st marks p|n/of st marks pl|e/of st marks|w/of central av	T	132
Hygeia Pl		T	7
HYLAN BLVD		P	68
Hylan Blvd	w/of seacrest a|e/of reynolds s|s/of yetman ave|s/of narrows rd|w/of coddingto|w/of chelsea st|w/of page ave|e/of page ave|w/of alter ave|s/of kingdom a|n/of ormsby ave|e/of burgher av|w/of bay st|e/of bedell av|n/of donley ave|w/of winchester|e/of norway ave|n/of dole st|n/of garretson a|e/of greencroft|e/of naughton a|n/of page ave|s/of sprague a|e/of huguenot|s/of aspinwall|s/of edgewater|w/of front st|w/of edgewater|w/of carteret s|e/of bay st|s/of donley ave|e/of bedell ave|e/of thornycrof|e/of burgher a|e/of aspinwall|s/of bay st|w/of penn ave|e/of delaware a|w/of delaware a|w/of quintard s|w/of edison st|w/of donley ave|w/of colton st|s/of luten ave|w/of edgewater s|s/of main st|w/of glover st|e/of parkinson|e/of atlantic|n/of bay st|e/of thornycroft|n/of quintard|w/of new dorp ln|e/of sprague a|w/of connecticu|e/of winchester|e/of connecticu|w/of main st|s/of bedell ave|w/of kay pl|e/of quintard st|s/of quintard s|e/of buel ave|e/of main st|e/of jacques av|e/of anderson st	T	1960
HYLAN BOULEVARD		P|S	15
Hylan Pl	e/of lincoln av	T	6
HYLAND BLVD		P	17
I/O GLEN ST	edward curry|edward curry blvd	P	4
I/O GULF AVE	bloomfield ave|edward curry blvd	P	7
I/O OSGOOD AVE	greenfield ave|park hill	P	4
I/O WALL ST	academy|stuyvesant pl|st marks pl	P	4
Ibsen Ave		T	20
Idaho Ave	e/of bloomingda	T	12
Ilion Pl	w/of dorothea pl|w/of dorothea p|e/of ebony st|w/of dorothea|e/of dorothea pl|n/of dorothea p	T	17
Ilyse Ct	w/of boyce ave	T	13
Ina St	w/of titus ave|n/of titus ave	T	14
Indale Ave	n/of woodvale a|n/of johnston	T	13
Independence Ave	s/of richmond|e/of richmond a	T	11
Ingram Ave	s/of marble st|n/of victory bl|n/of victory b|e/of victory bl|s/of victory bl	T	28
Innis St	e/of nicholas|e/of morningsta|e/of nicholas a|e/of morningst	T	63
Ionia Ave	e/of carlton b|w/of delmar av|w/of jefferson|w/of huguenot a|w/of delmar ave|e/of delmar ave|e/of huguenot a|e/of jefferson	T	155
IONIA AVE		P	9
IONIA AVENUE		S	4
Iowa Pl		T	5
Ironwood St	w/of sandalwoo|w/of sandalwood|s/of sandalwood	T	17
IRONWOOD ST		P	9
Irving Pl	s/of vanderbilt|e/of targee st|e/of van duzer|s/of hardy st|n/of delford st|e/of vanderbilt|e/of van duzer s|w/of vanderbilt	T	113
IRVING PL		P	8
IRVING PLACE		P	4
Irvington St	s/of hylan blv|e/of hylan blv|n/of hylan blvd|n/of edith ave|s/of hylan blvd|e/of hylan blvd|w/of edith ave	T	31
Isabella Ave	n/of mill rd|w/of mill rd|n/of medina st|s/of stoneham s|s/of hylan blv|e/of stoneham s|n/of leeds st|s/of stoneham	T	38
Isernia Ave		T	17
Islington St	e/of giffords l|n/of giffords l	T	12
Ismay St	w/of colonial a	T	21
JACKSON AVE		P	4
Jackson Ave	w/of robin rd|s/of mcclean ave	T	39
JACKSON ST		P	5
Jackson St	e/of william st	T	63
Jacob St		T	5
Jacques Ave	s/of clawson st|w/of edison st|n/of clawson st|s/of edison st|n/of hylan blvd|n/of edison st|s/of hylan blvd	T	123
JACQUES AVE		P	4
JACQUES AVENUE		P|S	6
Jaffe St		T	16
James Pl		T	11
Jansen St	e/of luten ave|w/of androvett|e/of androvette|e/of huguenot a|n/of androvett|s/of androvette|n/of androvette	T	36
Jardine Ave	e/of morgan ln|w/of renee pl|w/of morgan ln|e/of renee pl|n/of morgan ln	T	42
Jasper St		T	7
Jeannette Ave	w/of lucy loop	T	29
Jefferson Ave	n/of boundary a|w/of boundary a|s/of hylan blvd|e/of hylan blvd|s/of boundary av|e/of boundary a	T	173
JEFFERSON AVE		P	4
Jefferson Blvd	e/of rathbun av|s/of rathbun ave|w/of vespa ave|e/of edgegrove a|e/of sinclair a|s/of edgegrove|w/of edgegrove|n/of rathbun ave|s/of sinclair a	T	73
Jefferson St	n/of dongan hil|s/of dongan hill|w/of dongan hil|s/of seaver ave|e/of seaview ave|n/of garretson|w/of dongan hi|w/of stobe ave|e/of seaview av|e/of dongan hil|e/of dongan hi|s/of dongan hil|w/of seaview av	T	164
Jerome Ave	s/of quintard st|w/of mcclean a|s/of quintard s|w/of mcclean av	T	86
Jerome Rd	s/of quintard st|s/of quinn st|s/of old town ro|e/of quintard s|s/of quintard s|w/of quintard s|w/of burgher av|w/of evergreen|e/of evergreen|w/of quintard st	T	141
Jersey St	s/of richmond|s/of richmond t|w/of richmond t|w/of bank st|n/of crescent|e/of richmond t|n/of crescent a|n/of richmond t|s/of bank st|e/of crescent a|s/of crescent|s/of stanley ave|s/of crescent a|s/of richmond te|e/of castleton|e/of bank st|w/of castleton|e/of crescent	T	453
JERSEY ST		P	56
JERSEY STREET		P	20
JEWETT AVE		P	9
Jewett Ave	e/of watchogue|n/of victory bl|n/of wheeler av|n/of victory blv|e/of coale ave|e/of castleton|s/of zachary ct|w/of victory bl|w/of raymond av|n/of coale ave|n/of watchogue	T	606
JEWETT AVENUE		S|P	12
Joan Pl		T	16
Joel Pl		T	15
John St	s/of richmond te|s/of innis st|s/of richmond t|n/of innis st|e/of innis st|w/of innis st	T	152
JOHN ST		P	14
JOHN STREET		S|P	6
Johnson Ave	n/of arthur kil|s/of arthur kil|w/of arthur kil	T	13
Johnson Pl	w/of atlantic av|w/of burgher av	T	14
Johnson St	n/of arthur kil|w/of arthur kil	T	36
Johnston Ter	w/of bayview av	T	17
JOHNSTON TERR		P	4
Joline Ave	w/of poe st|n/of joline ln|e/of hylan blv|w/of amboy rd	T	47
Joline Ln		T	8
Jones St		T	7
Joseph Ave	w/of sunset ave	T	19
Josephine St	w/of manor rd	T	26
Journeay St	w/of union ave|s/of union ave	T	25
Joyce St	w/of naughton a|w/of naughton|n/of seaver ave	T	6
Jules Dr	n/of goethals|w/of lenore ct	T	118
JULES DR		P	6
JUMEL ST		P	7
Jumel St	e/of giffords l|e/of greaves a|w/of corbin ave|w/of miles ave|e/of greaves av|s/of greaves ave	T	68
Juniper Pl		T	7
Justin Ave		T	22
Kalver Pl	w/of pulaski ave|e/of pulaski av|w/of morningsta|e/of pulaski ave|e/of pulaski a	T	30
Karen Ct	w/of egbert ave|s/of egbert ave	T	8
Katan Ave	e/of eltingvill|w/of shafter av|w/of miles ave|e/of shafter av|e/of ridgeway a|w/of eltingville|w/of ridgewood|e/of getz ave|s/of ridgewood|w/of getz ave|e/of richmond av|e/of cortelyou	T	148
Kathy Pl		T	18
Keating Pl	n/of travis ave|s/of rockland|e/of seguine av|n/of travis av|s/of travis ave|s/of rockland a|s/of rockland av|s/of seguine ave|e/of rockland a|w/of rockland a|e/of rockland av	T	88
Keating St	w/of seguine av|n/of ormsby ave|n/of seguine av|e/of seguine av|s/of ormsby ave|e/of seguine a|w/of ormsby ave|s/of seguine av|w/of seguine ave|w/of holten ave	T	88
Keats St	e/of fieldway av|w/of ormsby ave	T	12
Keegans Ln		T	27
Keeley St	w/of scarboro a|n/of scarboro av	T	15
Keiber Ct	w/of westcott b	T	50
Kell Ave	w/of victory bl|n/of westwood av|s/of victory bl	T	71
Kelly Blvd	e/of klondike a|e/of travis ave|n/of travis ave|s/of travis ave|n/of mcveigh av|e/of braisted a|e/of mcveigh av|n/of travis av|n/of richmond hi	T	77
KELVIN AVE		P	6
Kelvin Ave		T	30
Kemball Ave	e/of westcott b	T	41
Kenilworth Ave	w/of arthur kil	T	39
Kenmore St		T	18
Kenneth Pl	w/of elder ave|e/of elder ave|n/of woodvale|w/of woodvale av	T	11
Kennington St		T	27
Kensico St	w/of richmond r|s/of richmond r|e/of center st	T	7
Kensington Ave	n/of olympia b|s/of mcclean av|n/of olympia bl	T	57
Kermit Ave	w/of parkinson a|n/of hylan blv|s/of parkinson a	T	61
King St	w/of richmond a|e/of wincheste|w/of ridgecres|w/of thornycrof|e/of thornycrof|n/of ridgecrest|w/of thornycro|w/of ridgecrest|s/of thornycrof|s/of richmond av|n/of richmond|e/of winchester|s/of beach rd|e/of thornycro|w/of thornycroft|s/of winchester|s/of richmond a	T	82
Kingdom Ave		T	24
Kinghorn St	e/of harold ave|w/of barclay av	T	23
Kingsbridge Ave		T	73
Kingsland St	w/of trenton ct|e/of trenton ct|w/of seguine av	T	12
Kingsley Ave	e/of seguine a	T	37
KINGSLEY PL		P	7
Kingsley Pl	n/of stanley av	T	17
Kinsey Pl	w/of woodcliff	T	15
Kirby Ct		T	15
Kirshon Ave		T	44
Kissel Ave	n/of forest ave	T	82
Kiswick St	w/of lincoln ave|s/of midland av|e/of midland av	T	32
Klondike Ave	w/of kelly blvd|e/of merrymount|w/of nehring av|s/of steinway av|e/of steinway av|e/of steinway a|n/of merrymount|e/of steinway|e/of nehring av|w/of merrymount|e/of lewiston st	T	217
KLONDIKE AVE		P	9
Knapp St	w/of freedom ave	T	9
Knesel St		T	55
Knollwood Ct	s/of amador st|e/of amador st|w/of amador st|n/of amador st|e/of birch rd|s/of birch rd|w/of birch rd	T	34
Knox Pl	w/of slosson ave	T	13
Knox St		T	5
Koch Blvd	w/of lyndale av|w/of seidman av|e/of seidman av|w/of arden ave|e/of harold ave|s/of woods of a|e/of richmond a|w/of hales ave|w/of seidman a	T	35
Kramer Ave	w/of lamport bl|s/of parkinson|s/of norway av	T	88
Kramer Pl	w/of jewett av|e/of jewett ave	T	26
Kramer St	e/of lamport bl|e/of ledyard pl|s/of norway ave|w/of norway ave|w/of norway av|w/of kensingto|e/of norwalk av|n/of norway av|w/of kensington|e/of kensington|w/of parkinson|s/of norway av|s/of lamport bl|e/of parkinson|e/of norway ave|n/of parkinson|n/of lamport bl|s/of parkinson|w/of lamport bl	T	182
Kreischer St	e/of androvette	T	15
Kruser St	n/of greeley a|n/of bancroft|n/of greeley av|s/of fremont av|w/of fremont av	T	21
Kunath Ave		T	11
Kyle Ct		T	11
LA SALLE STREET		S	4
Labau Ave	s/of northern b|e/of northern b	T	20
Laconia Ave	w/of hamden ave|w/of burgher av|w/of liberty ave|w/of evergreen|n/of slater blvd|e/of atlantic a|s/of cromwell a|n/of garretson|w/of liberty av|e/of cromwell a|e/of liberty ave|e/of stobe ave|w/of dongan hi|e/of raritan ave|n/of jefferson|s/of crowell av|e/of burgher ave|s/of alter ave|w/of garretson a|w/of cromwell av|s/of burgher av|e/of delaware av|w/of garretson|n/of cromwell a|n/of burgher av|s/of delaware av|w/of cromwell a|w/of jefferson a|e/of slater blv|e/of raritan av|e/of cromwell av|w/of delaware av|e/of garretson a|n/of slater blv|s/of cromwell av|w/of atlantic av|e/of delaware|s/of quintard s|w/of quintard s|e/of atlantic av|n/of cromwell av|w/of slater blv|w/of buel ave|e/of garretson|e/of burgher av|w/of seaver ave|e/of quintard s|e/of jefferson|w/of alter ave|w/of delaware a|n/of delaware av|n/of stobe ave|w/of stobe ave|s/of jefferson	T	649
Ladd Ave	w/of annadale r	T	10
Lafayette Ave	n/of henderson|s/of fillmore s|s/of henderson|s/of henderson a|s/of fillmore|n/of fillmore st	T	164
Lafayette St	n/of fillmore s	T	5
Laforge Ave	e/of beekman st|w/of port richm	T	28
Laforge Pl	n/of hooker pl	T	16
Lagrange Pl	n/of beekman st|s/of beekman st|s/of beekman s|e/of beekman st|w/of catherine|n/of beekman s	T	38
Laguardia Ave	e/of schmidts l|s/of poland pl|w/of poland pl|n/of westwood|s/of westwood a|s/of waldo pl|s/of schmidts|w/of westwood|n/of waldo pl|e/of westwood a|s/of schmidts l|e/of waldo pl|e/of poland pl|n/of poland pl|w/of schmidts l|n/of westwood a|s/of westwood|n/of westwood av|w/of westwood a|s/of westwood av|s/of tillman st	T	173
Lake Ave	n/of forest ave|e/of richmond te|s/of richmond t|e/of richmond t|s/of walker st|n/of walker st|w/of richmond t|w/of wenlock s	T	308
LAKE AVE	richmond terr	P	17
LAKE AVENUE		S	11
Lakeland Rd		T	12
Lakewood Rd		T	5
Lambert St	w/of comstock|w/of comstock a|e/of comstock a|s/of comstock a|s/of comstock av|e/of huguenot a	T	31
Lamberts Ln	s/of elson st|w/of elson st|e/of longdale st|e/of globe ave|w/of may ave|n/of elson st|e/of kingsbridg|w/of richmond a|e/of longdale s|e/of elson st	T	136
Lamoka Ave	w/of richmond av|n/of richmond a|w/of bartlett a|w/of ridgewood|w/of armstrong|e/of ridgewood a|n/of armstrong|n/of bartlett a	T	144
Lamont Ave	e/of ellsworth a|e/of marcy ave	T	75
LAMPORT BLVD		P	14
Lamport Blvd	e/of foch ave|s/of kramer st	T	235
LANDER AVE	graham ave	P	4
Lander Ave	w/of richmond	T	59
Langere Pl	n/of lynhurst a|s/of willow ave	T	15
Lansing St	e/of balfour st|s/of olympia bl	T	23
Laredo Ave	s/of annadale r	T	43
Larkin St	e/of faber st|e/of sharpe ave	T	32
Lasalle St	w/of granite a|s/of morningsta|w/of granite av|w/of winans st|e/of houseman av|w/of morningsta|e/of winant st|e/of granite av|n/of houseman a|e/of houseman a|s/of winant st|e/of winans st|s/of granite av|w/of winant st	T	175
Lathrop Ave	w/of livermore|w/of clinton b	T	45
Latimer Ave	w/of shenandoah|e/of victory bl|s/of baron blv|n/of shenandoah	T	53
Latourette St	w/of woodvale a|e/of s goff ave|s/of s goff ave|e/of s goff av|s/of sharrott av	T	65
Laurel Ave	n/of warren st|w/of targee st|n/of gordon st|s/of targee st|s/of warren st|w/of warren st	T	101
Lawrence Ave	s/of harvest ave|n/of forest ave|e/of forest ave|s/of forest av|n/of morrison av|s/of forest ave	T	278
Layton Ave	w/of westervelt|s/of westervelt|e/of westervelt|n/of westervelt|s/of westervel	T	71
LAYTON AVE		P	6
Ledyard Pl		T	14
Lee Ave	w/of amboy rd|e/of arthur kill	T	38
Leeds St	e/of guyon ave	T	13
Legate Ave	n/of carlton bl|s/of carlton bl|n/of carlton b	T	13
Leggett Pl	n/of hillman ave	T	15
Legion Pl	s/of narrows rd	T	14
Leigh Ave	w/of elson st	T	9
Lenevar Ave	s/of rathbun av|s/of rathbun a|w/of lamont ave|s/of rensselaer|e/of ionia ave|n/of rathbun av|e/of rathbun ave|s/of edgegrove|s/of sheldon av|n/of lamont ave|e/of sheldon av|s/of ionia ave|s/of rensselae|e/of rensselaer|n/of sheldon av|s/of sinclair a|e/of sheldon ave|w/of sheldon av	T	61
Lenhart St		T	25
Lenore Ct	n/of regis dr|s/of regis dr|e/of regis dr|n/of jules dr|s/of ada dr|w/of jules dr|s/of jules dr	T	45
Lenzie St		T	10
LEONA ST		P	4
Leona St	s/of morani st	T	32
Leonard Ave	n/of willowbro|w/of dickie ave|w/of demorest a|n/of willowbroo|e/of livermore|w/of crystal av|w/of deems ave|w/of clinton b|e/of clinton b|w/of livermore|w/of st john av|e/of clinton b f|e/of bidwell av|n/of demorest a|e/of wardwell a|e/of willard av|e/of deems ave	T	42
Leonore Ct	e/of regis dr|e/of ada dr|e/of jules dr|w/of ada dr	T	7
Leroy St	n/of victory bl|n/of victory blv|w/of victory bl	T	32
Leslie Ave	e/of parkinson	T	10
Lester St	s/of victory bl	T	13
Leverett Ave	e/of giffords ln|e/of giffords l|e/of stieg ave|w/of lovelace a|w/of stieg ave|e/of richmond av|w/of armstrong a|e/of linton pl	T	127
LEVERETT AVE		P	21
LEVERETTE AVE		P	5
Levit Ave	s/of vedder av|w/of vedder ave|w/of home pl	T	30
LEWISTON ST	rome ave	P	5
Lewiston St	s/of klondike a|s/of klondike|w/of travis ave	T	102
Lexington Ave	w/of palma dr|s/of catherine s|s/of catherine|e/of catherine|w/of catherine|e/of palmer ave|w/of palmer ave|s/of palmer ave	T	141
Leyden Ave	e/of harbor rd|s/of harbor rd|n/of harbor rd	T	20
Liberty Ave	e/of mason ave|w/of richmond r|e/of richmond r|n/of hylan blvd|s/of seaview av|e/of hylan blvd|n/of richmond rd|w/of olympia bl|n/of mason ave|e/of olympia bl|e/of richmond rd|s/of olympia bl|s/of hylan blvd|w/of hylan blvd|s/of richmond rd|s/of mason ave|n/of olympia blv|w/of mason ave|n/of richmond r	T	467
LIBERTY AVE		P	6
Lighthouse Ave	n/of richmond r	T	5
Lightner Ave		T	9
Lilac Ct	s/of forest ave	T	15
LILY POND AVE		P	4
Lily Pond Ave	w/of ocean ave	T	27
LINCOLN AVE		P	8
Lincoln Ave	e/of sanilac st|w/of oldfield s|s/of mason ave|s/of poultney s|n/of poultney st	T	211
Lincoln Pl	n/of fingerboar|e/of fingerboar|s/of fingerboar|w/of fingerboar	T	19
Lincoln St	e/of manor rd|s/of manor rd	T	28
Linda Ave		T	25
Lindbergh Ave	n/of clawson st|s/of clawson st|w/of clawson st|n/of clawson s	T	39
Linden Ave		T	4
Linden St	e/of bard ave	T	12
Lindenwood Rd	w/of giffords|s/of pleasant st|e/of giffords g|n/of giffords gl|n/of pleasant st|n/of amboy rd	T	41
Linton Pl	n/of leverett|e/of giffords l	T	12
Linwood Ave	w/of giffords g|s/of mcclean a|s/of mcclean av|e/of mcclean ave	T	28
Lion St		T	6
LISA LANE		P	5
Lisa Ln	w/of ebey ln|s/of ebey ln	T	14
Lisa Pl	w/of forest st|s/of victory b|s/of victory bl|w/of victory bl|n/of victory bl|e/of victory bl|n/of forest st	T	19
Lisbon Pl		T	38
LISK AVE		P	11
Lisk Ave	e/of ludwig ln|w/of amity pl	T	151
Liss St	w/of woods of ar|e/of woods of ar	T	14
Little Clove Rd	n/of walters av|s/of victory bl|s/of walters av|w/of seneca ave|s/of walters ave|s/of tioga st|n/of windsor rd|s/of seneca ave|e/of tioga st|n/of walters ave|e/of walters av|s/of victory b|e/of renwick av	T	54
Littlefield Ave		T	11
Livermore Ave	s/of st marys|s/of watchogue|w/of watchogue|e/of watchogue r	T	104
Livingston Ave	n/of brielle ave	T	122
LIVINGSTON AVE		P	6
Llewellyn Pl	n/of forest ave|s/of forest ave|e/of forest ave	T	130
LLEWELLYN PL		P	11
Lockman Ave	n/of brabant st|n/of barbara st|s/of netherland|s/of harbor loo|w/of richmond t|s/of brabant st|w/of roxbury st|e/of roxbury st|s/of richmond t|n/of roxbury s|s/of brabant s|w/of brabant st|e/of richmond t|w/of roxbury s|s/of roxbury st|w/of netherland	T	472
LOCKMAN AVE	brabant st|continental pl	P	12
Lockwood Pl		T	12
Locust Ave	s/of hylan blvd|e/of richmond r|e/of nelson ave	T	72
Locust Pl	w/of hillside t|e/of brown ave|e/of nelson ave|n/of hillside te|w/of nelson ave	T	55
Logan Ave		T	37
Lombard Ct	w/of arthur ki|n/of country ln|e/of huguenot|e/of huguenot av|s/of huguenot a|e/of huguenot a	T	25
Longdale St	w/of lamberts ln|n/of gauldy ave|s/of fahy ave|e/of fahy ave	T	69
Longview Rd	w/of starbuck s	T	20
Loretto St	w/of clermont a	T	47
Loring Ave		T	17
LORING AVE		P	9
Lorraine Ave	barb st|enaview st  lorrine	T	21
Lortel Ave	e/of todt hill|e/of todt hill r|e/of melhorn rd	T	23
Lovelace Ave	n/of figurea av	T	19
Lovell Ave	s/of ashworth a	T	13
Ls Christopher lane	victory blvd x lambe|victory blvd x lande|victory blve x lande	S	7
Lucille Ave		T	18
Ludlow St	w/of elizabeth s	T	20
LUDWIG LANE		S|P	20
Ludwig Ln	e/of amity pl	T	94
LUDWIG LN		P	9
Ludwig St	n/of elizabeth s|w/of elizabeth s|s/of elizabeth s|w/of elizabeth|e/of elizabeth s	T	28
Luigi Pl	s/of beacon ave	T	7
Luke Ct		T	25
Luten Ave	n/of billiou st|s/of amboy rd|n/of billiou s|w/of eylandt s|e/of jansen st|s/of eylandt s|s/of eylandt st|s/of hylan blv|s/of billiou st|n/of jansen st|s/of jansen st|w/of amboy rd|n/of eylandt st|e/of eylandt s|n/of hylan blv|w/of jansen st|n/of eylandt s|w/of eylandt st|n/of deisius st|e/of amboy rd	T	153
LUTEN AVE		P	6
Lyle Ct		T	11
Lyman Ave	w/of tompkins a	T	79
Lyman Pl		T	4
LYNBROOK AVE		P	7
Lyndale Ave	s/of amboy rd|e/of amboy rd|n/of oakdale st|s/of oakdale st	T	101
Lynhurst Ave	w/of bay st|e/of bay st|s/of tompkins a	T	33
Lynn St	n/of adelaide a|e/of isabella	T	19
Lyon Pl		T	20
Mace St		T	23
Macfarland Ave	w/of hastings s|s/of wallace ave|s/of sand ln|s/of hastings s|e/of sand ln|w/of wallace ave	T	102
Macon Ave		T	23
Macormac Pl		T	38
Madera St	s/of amboy rd	T	11
Madigan Pl	n/of spring st|n/of wilson ter	T	8
Madison Ave		T	24
Madsen Ave		T	49
Magnolia Ave	w/of garrison a|w/of garretson	T	10
Maguire Ave	w/of sheldon av|s/of correll a|e/of ramona ave|w/of fonda pl|n/of rensselae|w/of rensselaer|w/of correll a|s/of rathbun a|n/of sheldon av|e/of sheldon av|s/of rathbun av|e/of sinclair av|s/of ramona ave|n/of sheldon a|w/of sheldon ave|n/of rathbun av|s/of rensselae|e/of rathbun av|s/of rensselaer|s/of sheldon a|s/of stafford a|s/of ramona av|e/of sinclair a|s/of sheldon av|n/of rensselaer|e/of rensselaer|n/of rathbun ave|n/of rathbun a|n/of stafford a|e/of ramona av|s/of sinclair a|n/of ramona av|e/of rathbun ave	T	136
MAGUIRE AVE	i/o stafford ave|drumgoogle rd w	P	5
Maiden Ln	n/of hecker st|e/of lion st|w/of lion st|s/of bethel ave	T	8
Main St	s/of amboy rd|w/of amboy rd|n/of amboy rd|s/of hylan blvd	T	101
MAIN ST	i/o craig ave|arthur kill rd	P	7
MAIN STREET		P|S	7
Maine Ave	e/of manor rd|w/of manor rd|e/of clinton b f	T	45
Major Ave	w/of sand ln|w/of tompkins|s/of hastings s|w/of tompkins a|s/of landis ave|e/of duer ave|e/of sand ln|w/of pebble ln|e/of lily pond|n/of tompkins a|s/of tompkins a	T	120
Malden Pl		T	48
Mallory Ave	s/of hylan blvd|s/of lava st|n/of olympia bl|s/of foch ave|w/of kramer st	T	90
Mallow St	s/of barrow pl|n/of alverson a|w/of barrow pl	T	65
MALONE AVE		P	22
Malone Ave		T	75
MALONE AVENUE		P|S	8
Malvine Ave		T	14
Manchester Dr	manchester road|n/of rosedale a|e/of vespa ave|w/of green valle|s/of green vall|s/of green valle	T	73
MANCHESTER DR		P	4
Manhattan St	e/of pittsville|s/of billop ave|w/of billop ave	T	72
Manila Ave		T	19
Manila Pl	w/of ebbitts st	T	5
Mann Ave	s/of victory bl	T	43
MANOR RD	maine ave	P	7
Manor Rd	e/of brielle a|w/of fanning st|w/of brielle a|e/of victory bl|w/of lincoln st|n/of brielle av|s/of brielle a	T	238
Mansion Ave	n/of cleveland	T	45
Manton Pl	w/of mosel ave	T	10
Maple Ave	e/of harrison|s/of harrison av|w/of harrison av|n/of harrison av|e/of harrison a|n/of richmond t|e/of richmond t|n/of harrison a|s/of richmond t|n/of grove ave|e/of grove ave|w/of port richm|e/of harrison av|s/of richmond te	T	155
MAPLE AVE		P	4
Maple Ct	s/of dogwood dr	T	5
MAPLE PARKWAY		S|P	5
MAPLE PKWY		P	11
Maple Pky	n/of linden ave|n/of forest ave|n/of netherland	T	358
MAPLE TERRACE		S	6
Mapleton Ave	s/of colony ave|e/of colony ave|w/of patterson|n/of patterson	T	45
Maplewood Ave	n/of pinewood a|e/of pinewood a|e/of park st|w/of pinewood a	T	10
Maplewood Pl	n/of hylan blvd	T	8
Marble St	s/of victory bl	T	20
Marcy Ave		T	23
Margaret St	e/of rhett ave|w/of rhett ave|w/of giffords l	T	63
Margaretta Ct	e/of jewett ave	T	51
Marianne St		T	6
Marine Way	e/of roma ave|n/of milton ave	T	35
Marion Ave	e/of dubois av|e/of dubois ave	T	25
Marion St	n/of dubois ave|e/of dubois ave|w/of dubois ave|w/of greenleaf a|e/of dubois av|w/of greenleaf	T	39
Marisa Cir	s/of bloomingda|s/of bloomingd|e/of bloomingda|e/of bloomingd	T	34
MARISA CIR		P	5
MARISA CIRCLE		P	7
Mark St	e/of broadway|n/of richmond r|s/of richmond r	T	18
Market St	s/of north burg|e/of broadway|w/of n burgher a|e/of n burgher a|s/of campbell av|s/of broadway|w/of broadway|n/of north burg	T	60
MARKET STREET		P	7
Markham Pl		T	9
MARNE AVE		P	7
Marne Ave		T	13
Marscher Pl	e/of seguine a	T	42
Marsh Ave	w/of richmond|e/of westport s|n/of windham lo|e/of windham lo|n/of richmond h|s/of windham lo|w/of elmwood pa|n/of essex dr|s/of richmond h|s/of elmwood pa|n/of elmwood p|n/of elmwood pa|n/of windham l|w/of windham lo|s/of richmond|e/of platinum a|e/of richmond|w/of richmond h|s/of westport s|s/of westport|w/of westport s	T	63
MARSH AVE		P	9
Marsh Ave & Platinum	ave	S	5
Marshall Ave	w/of elmwood p|w/of bogert ave	T	6
Martha St	e/of howard ave|w/of howard ave|e/of clove rd|w/of clove rd|s/of clove rd|n/of clove rd|w/of howard av	T	39
Martin Ave	s/of victory b	T	89
Martineau St	n/of northfield|e/of northfield	T	18
Martling Ave		T	7
Marvin Rd	s/of bloomingda	T	14
Marx St		T	6
Mary St	e/of richmond rd|e/of richmond r	T	7
Maryland Ave	e/of bay st|s/of reynolds s|n/of tompkins|e/of foxholm st|w/of fox hill t|w/of bay st|e/of tompkins av|s/of tompkins a|w/of prospect s	T	188
MARYLAND AVE		P	7
MARYLAND AVENUE		P|S	4
Mason Ave	s/of liberty ave|e/of stobe ave|e/of seaview ave|n/of jefferson|s/of buel ave|s/of adams ave|e/of cromwell av|e/of cromwell a|e/of dongan hil|n/of stobe ave|n/of seaview av|s/of garretson|w/of liberty av|s/of dongan hi|w/of cromwell av|n/of slater bl|n/of dongan hil|e/of liberty av|e/of jefferson|w/of seaview a|w/of crowell av|s/of seaview av|n/of garretson|n/of raritan ave|e/of seaview av|w/of alter ave|w/of seaview ave|w/of cromwell a|w/of buel ave|e/of garretson|n/of liberty av|w/of adams ave|e/of seaview a|w/of seaview av|w/of benton ave|w/of garretson|w/of garretson a|n/of cromwell a|e/of liberty ave|w/of jefferson|e/of new dorp l|w/of liberty ave|e/of garretson a|s/of garretson a|e/of alter ave|e/of adams ave|s/of liberty av|n/of raritan av|s/of jefferson|w/of stobe ave|e/of seaver ave|w/of hamden ave|n/of deal ct|e/of deal ct	T	5388
Mason Blvd	s/of maguire av|e/of garretson a|w/of seaview av|w/of rossville a|w/of rossville	T	136
Mason St		T	9
Massachusetts St		T	10
Mathews Ave	e/of lawrence a|e/of pelton ave|w/of hart ave	T	11
May Ave	s/of ada dr|s/of lamberts ln	T	27
May Pl	n/of amboy rd|s/of mosely ave	T	11
Mayberry Promenade	s/of strawberry|w/of strawberry	T	63
Maybury Ave	w/of ainsworth a	T	44
Maybury Ct	e/of redgrave a|n/of redgrave a|w/of redgrave a	T	11
McArthur Ave		T	22
McBaine Ave	s/of bloomingdal	T	86
McClean Ave	s/of jerome ave|e/of lamport b|e/of norway ave|w/of norway ave|w/of lily pond|e/of duer ave|e/of tompkins av	T	146
McCormick Pl		T	12
McCully Ave	w/of st andrew	T	30
McDermott Ave		T	4
McDivitt Ave		T	19
McDonald St		T	4
McGregor St	w/of sheldon av|e/of ramona ave|w/of sinclair a	T	16
McKee Ave		T	13
McKinley Ave	e/of natick st|s/of richmond r|n/of center st|e/of ardsley s|e/of richmond r|e/of clarke ave|w/of richmond r|s/of richmond	T	9
McLaughlin St		T	26
MCLAUGHLIN ST		P	6
McVeigh Ave	w/of kelly blvd|w/of denker pl|e/of evans st|e/of kelly blvd|s/of kelly blvd	T	74
Meadow Ave	s/of spring st|n/of rome ave|e/of stobe ave|e/of rome ave|w/of rome ave|s/of jefferson	T	26
Meadow Pl	e/of jefferson|e/of stobe ave|n/of stobe ave|n/of jefferson	T	33
MEADOW PLACE		P	4
Medina St	w/of oak ave|w/of guyon ave	T	56
Meisner Ave	e/of rockland a	T	8
MELBA ST		P	5
Melba St	s/of brielle av|s/of harold st|w/of brielle a|e/of brielle av|n/of harold st|e/of harold st|s/of queen st|w/of harold st	T	167
Melhorn Rd	e/of motley ave|s/of lortel ave|e/of schmidts l	T	12
Melrose Ave	e/of victory blv	T	9
Melrose Pl	e/of cleveland|e/of cleveland a	T	9
Melville St	s/of walch pl|w/of walch pl|e/of seguine a|s/of seguine av|e/of seguine ave	T	56
Melvin Ave	e/of wild ave|s/of wild ave|n/of victory bl|n/of wild ave|s/of walch pl|e/of victory bl|w/of victory bl|s/of victory blv|w/of wild ave	T	75
Melyn Pl	s/of wenlock st|e/of wenlock st|n/of westbrook|s/of wenlock s|s/of westbrook	T	26
Memo St	s/of trenton ct|w/of seguine ave|s/of seguine ave|n/of seguine ave	T	35
Memphis Ave	e/of richmond av|w/of richmond a	T	62
Mercer Pl	e/of cleveland	T	12
Meredith Ave	s/of south ave	T	10
MEREDITH AVE		P	6
Merle Pl	w/of fingerboard|w/of fingerboar|n/of fingerboard|s/of fingerboar|w/of wenlock st	T	49
MERLE PL		P	13
MERLE PLACE	dugdale st	P	7
Merrill Ave	e/of hillman av|s/of hillman a|e/of graham ave|w/of richmond a|w/of hillman av|e/of arlene st|w/of richmond|e/of richmond a|e/of firth rd|e/of richmond	T	104
MERRILL AVE		P	8
Merriman Ave	w/of manor rd	T	7
Merrymount St	w/of travis ave|n/of travis ave|e/of travis ave|s/of travis ave	T	123
MERRYMOUNT ST		P	5
Mersereau Ave	w/of downey pl|s/of wemple st|s/of netherland|e/of wemple st|n/of christophe|s/of downey pl	T	129
MERSEREAU AVE		P	7
Metcalfe St	n/of van duzer|e/of van duzer|e/of vanderbilt	T	52
METCALFE ST		P	6
Metropolitan Ave	s/of forest av|s/of forest ave|e/of forest ave|n/of forest ave|n/of thames ave	T	111
Middle Loop Rd		T	13
Midland Ave	s/of boundary av|s/of mason ave|e/of boundary|n/of hylan blvd|s/of boundary a|s/of boundary|n/of boundary a|n/of mason ave	T	190
MIDLAND AVE		P	7
Midland Rd		T	12
MILBANK ROAD		P|S	18
Mildred Ave	e/of shelly ave|s/of burke ave|e/of burke ave|n/of shelly ave|n/of burke ave|s/of shelly ave	T	37
Miles Ave	w/of daleham st|s/of elkhart st|e/of elkhart st|s/of fairfield|e/of gurley ave|s/of daleham st|n/of leverett a|n/of daleham st|n/of fairfield s|e/of daleham st|n/of gurley ave|s/of gurley ave	T	81
Milford Ave	e/of ocean ter|e/of burke ave	T	5
Mill Rd	w/of new dorp ln|n/of tysens ln|s/of tysens ln|e/of tysens ln|w/of tysens ln	T	274
MILL RD		P	11
MILL ROAD		P|S	7
Miller St	n/of constant av	T	15
MILLS AVE		P	4
Mills Ave	s/of mcclean av|s/of cedar ave	T	52
Milton Ave	w/of new dorp|w/of new dorp l	T	75
MILTON AVENUE		S	5
Minerva Pl	n/of fillmore s	T	5
Minna St		T	6
Minthorne St	n/of victory bl|e/of victory blv|s/of bay st|e/of victory bl|w/of bay st|w/of victory blv|n/of bay st|e/of bay st|n/of victory blv|s/of victory blv|s/of victory bl|s/of ramona ave	T	108
Minturn Ave	n/of albourne a|s/of rathbun av|s/of rathbun a|n/of ramona ave	T	15
Mobile Ave	s/of amboy rd|n/of amboy rd	T	20
Moffett St		T	23
Monahan Ave	s/of kelly blvd|e/of kelly blvd|w/of kelly blvd	T	80
MONAHAN AVE		P	7
Monroe Ave	s/of fort pl|s/of benziger av|n/of victory blv|n/of victory bl|w/of victory bl|e/of fort pl	T	145
MONROE AVE		P	8
Monroe Pl	e/of suffolk ave|n/of livingston	T	17
Montauk Pl		T	5
Montell St		T	23
MONTEREY AVE		P	5
Monterey Ave		T	17
Montgomery Ave	w/of victory blv|s/of fort pl|n/of victory bl|n/of victory blv|e/of fort pl|w/of fort pl	T	404
MONTGOMERY AVE		P	6
MONTGOMERY AVENUE		S	4
Monticello Ter		T	6
Montreal Ave	e/of pendale st|e/of clarke ave	T	53
MONTREAL AVE		P	4
Montvale Pl		T	8
Moody Pl	e/of bard ave	T	26
Moore St	s/of richmond r	T	4
Morani St	e/of richmond a|n/of leona st|n/of victory b|s/of leona st|w/of leona st|w/of debbie st|e/of richmond|w/of jennifer p|e/of jennifer p|e/of leona st|n/of debbie st|e/of debbie st|w/of richmond a|e/of jennifer pl|e/of victory bl|w/of jennifer pl|n/of victory bl|n/of richard ln|w/of parkview l	T	130
Moreland St	w/of greeley av|s/of midland av	T	55
MORENO CT		P	5
Morgan Ln	e/of hillman ave	T	25
Morley Ave		T	4
Morningstar Rd	e/of richmond|s/of hooker pl|s/of wenlock st|n/of richmond|e/of newark ave|e/of hooker pl|s/of richmond|s/of richmond t|n/of innis st|s/of lasalle st|e/of lasalle st	T	323
Morris Pl		T	4
Morris St	w/of rossville|s/of rossville|n/of rossville|e/of rossville a|w/of rossville a	T	52
Morrison Ave	e/of oakland av|e/of bement ave|n/of davis ave|w/of broadway|w/of pelton ave|s/of n burgher|e/of broadway|e/of davis ave|w/of lawrence a|w/of oakland ave|w/of davis ave|w/of oakland av|e/of oakland ave|w/of bement ave	T	113
MORRISON AVE		P	5
Morrow St	s/of forest ave|e/of richmond	T	5
MORROW ST	forest ave|c/o forest ave	P	18
Morse Ave		T	24
Morton St		T	4
Mosel Ave	n/of pierce st|w/of richmond a	T	124
MOSEL AVE		P	5
MOSEL AVENUE		S	9
Mosely Ave	e/of richmond a|w/of bamberger|n/of richmond a|s/of eagan ave|w/of richmond a|w/of richmond av|e/of bamberger|s/of richmond a|w/of port richm|e/of richmond av	T	401
Motley Ave	e/of melhorn rd|e/of melhorn r	T	15
Mott St		T	5
Mountainview Ave	s/of victory b|n/of harold st|n/of victory bl|s/of brielle ave|n/of holden blv|s/of victory bl|n/of brielle ave|n/of brielle av|e/of brielle ave	T	156
Mountainview ave and	s.gannon ave|s.gannon|gannon ave south|harold street|gannon ave soutj	S	6
Mulberry Ave		T	51
Mulberry Cir	n/of rivington a	T	62
Muller Ave		T	20
Mundy Ave	s/of forest ave|n/of ravenhurst|n/of benedict|n/of egbert ave|w/of benedict a|e/of forest ave|w/of egbert ave|s/of egbert ave	T	44
Murdock Pl	e/of renfrew pl|w/of renfrew pl	T	15
Murray Hulbert Ave	s/of victory b|w/of victory b|s/of victory bl|e/of victory bl|s/of bay stree|e/of victory blv|w/of victory blv|s/of victory blv|w/of victory bl|w/of hannah st|n/of hannah st|s/of bay st|e/of victory b	T	79
Murray Pl		T	4
MYRNA LANE	lisa lane	P	6
MYRNA LN		P	7
Myrna Ln	n/of stack dr|s/of stack dr	T	23
Myrtle Ave	e/of broadway|w/of n burgher|w/of bement ave|e/of elizabeth|w/of broadway|w/of elizabeth	T	139
N BURGHER AVE		P	6
N Burgher Ave	n/of harvest av|s/of delafield|w/of bosworth s|w/of forest ave|s/of bosworth s|s/of morrison|s/of cary ave|w/of blaine ct|e/of castleton|s/of myrtle ave|w/of castleton|n/of e raleigh a|s/of morrison a|s/of forest ave|s/of castleton|n/of castleton|e/of forest ave|s/of morrison av|n/of morrison av|s/of south st|s/of henderson|n/of morrison a	T	364
N Gannon Ave	w/of clermont pl|w/of gower st|w/of woodward|e/of crafton av|e/of ingram ave|e/of sheraden a|n/of wheeler a|w/of ingram ave|e/of sheraden av|w/of fingerboa|e/of gansevoor|w/of manor rd|e/of gower st|e/of warwick a|w/of mountainvi|w/of todt hill	T	44
N Mada Ave	s/of forest ave|n/of forest ave|s/of castleton a	T	51
N Pine Ter		T	9
N Railroad Ave	e/of cromwell a|s/of burgher av|n/of garretson a|e/of windemere|w/of midland av|w/of cromwell a|e/of delaware a|w/of alter ave|e/of justin ave|e/of steele ave|n/of guyon ave|w/of fremont ave|e/of old town r|n/of burbank a|w/of adams ave|w/of lincoln av|w/of windemere|w/of jefferson a|w/of locust ave|e/of guyon ave|e/of alter ave|e/of locust av|e/of stobe ave|n/of old town r|e/of burbank a|w/of guyon ave|e/of cloister p|e/of barton av|n/of steele ave|e/of burbank av|w/of locust av|n/of justin ave|n/of evergreen a|e/of seaview av|n/of stobe ave|e/of emmet ave|w/of steele ave	T	594
N RAILROAD AVE		P	6
N Railroad St		T	7
N Randall Ave		T	12
N Rhett Ave		T	8
N St Austins Pl	e/of davis ave|e/of st austins|s/of bard ave|s/of davis ave|w/of st austins|w/of bard ave|e/of bard ave|n/of bard ave|w/of davis ave|n/of davis ave	T	176
N/S NICK LAPORTE PL	w/o bay st|e/o stuyvesant pl|w/o bay srt	P	6
N/S of GOETHALS ROAD	north 1000' n/o for|north 800' e/o fore|north 550' w/o sout|north 500' n/o sout|north 500' e/o fore|north 1400' w/o sou|north 1200' e/o for	S	21
N/S of NARROWS ROAD	north 100' e/o north|south 70' n/o weser|north 75' w/o north	S	6
N/S of PARK HILL CIR	cle 10' e/o osgood a	S	4
N/S of VETERANS ROAD	west 528' e/o rossv|west 550' e/o rossv|west 500' w/o arthu|west 3600' e/o ross|west 100' w/o arthu|west 400' w/o arthu|west 50' s/o arthur|west 700' e/o rossv|west 250' e/o arthu|west 500' e/o rossv|west 1056' w/o arth|west 200' w/o arthu|west 400' e/o rossv|west 250' w/o arthu|west 7920' e/o arth|west 200' e/o rossv|west 450' w/o arthu	S	26
N/S of WATER STREET	50' e/o front street|300' s/o front stree|40' e/o front street|100' w/o navy pier c	S	4
Nadal Pl	n/of fieldstone	T	6
Nahant St	e/of dunbar st|w/of corbin ave|s/of dunbar st|e/of corbin ave	T	14
Narrows Rd	e/of lily pond|w/of hastings|e/of hylan blvd|s/of hastings|w/of hylan blvd|w/of hylan blv|s/of hastings st|e/of fingerboa|w/of lily pond|e/of hastings|e/of fingerboar|e/of legion pl	T	39
Narrows Rd N	e/of gansevoort	T	33
NARROWS RD NORTH	north drive	P	5
Narrows Rd S	s/of hylan blv|e/of hylan blv|e/of fingerboa|w/of hastings s|e/of hastings s|s/of legion pl|n/of legion pl|e/of fingerboar|w/of fingerboar|w/of savo ln|s/of hylan blvd|w/of hastings|s/of hastings|e/of hylan blvd|w/of legion pl|n/of hastings s|w/of fingerboa|s/of hastings s|w/of hylan blvd|s/of fingerboa|s/of fingerboar|e/of hastings	T	158
NARROWS RD S		P	4
NARROWS RD SOUTH		P	4
Nash Ct	e/of nelson ave|e/of nelson av	T	20
Nashville St		T	14
Natick St		T	12
Naughton Ave	s/of zoe st|n/of mason ave|e/of zoe st|n/of cletus st|s/of hylan blvd|w/of mason ave|s/of mason ave|e/of quincy ave|w/of husson st	T	146
NAUGHTON AVE		P	4
Nautilus St	w/of bay st|n/of cliff st	T	25
Navesink Pl	n/of hett ave|n/of finley ave|s/of hett ave|w/of roma ave|w/of hett ave	T	19
NAVY PIER COURT		S|P	25
NAVY PIER CT		P	13
Neal Dow Ave	s/of springfiel|n/of maine ave|s/of maine ave|s/of watchogue	T	43
Neckar Ave	s/of steuben st|n/of steuben st|w/of steuben st|n/of steuben s|s/of pierce st|e/of steuben st	T	57
NECKAR AVE		P	4
Nedra Ln	w/of arden ave|e/of arden ave|s/of arden ave|n/of arden ave	T	39
Nehring Ave	n/of travis ave|n/of klondike av|w/of travis ave|s/of braisted av|s/of travis ave	T	68
Nelson Ave	e/of hylan blvd|s/of bower ct|s/of giffords g|s/of fitzgerald|n/of grandview|n/of brower ct|w/of bower ct|n/of amboy rd|n/of giffords g|n/of richmond a|w/of brower ct|s/of brower ct|e/of brower ct|w/of giffords g|e/of fitzgerald|w/of amboy rd|e/of amboy rd|s/of amboy rd|w/of hylan blvd|w/of fitzgerald	T	337
NELSON AVENUE	giffords glen	P|S	6
Neptune Pl	w/of willowbro|s/of victory bl|w/of willowbrook|w/of victory bl	T	14
Neptune St		T	8
NEPTUNE STREET		S	5
NETHERLAND AVE	lockman ave	P	12
Netherland Ave	e/of maple pky|s/of simonson a|w/of simonson a|n/of maple pky|e/of grandview	T	86
NEW DORP LANE		P	6
New Dorp Lane Munici	permit area	T	89
New Dorp Ln	w/of 9th st|e/of 9th st|e/of clawson s|s/of titus ave|w/of edison st|w/of clawson st|e/of clawson st|n/of winham ave|n/of new dorp p|n/of titus ave|w/of clawson s|w/of 8th st|s/of new dorp pl|n/of clawson st|n/of milton ave	T	5029
New Dorp Plz North	w/of new dorp ln|e/of new dorp l|w/of new dorp l|w/of beach ave|e/of cloister p|e/of beach ave|w/of cloister p|e/of ross ave|w/of ross ave|w/of rose ave|w/of cloister pl	T	1032
New Dorp Plz South	w/of jacques av|w/of new dorp l|e/of jacques av|w/of rose ave|w/of ross ave|e/of new dorp l|e/of ross ave|w/of jacques ave	T	468
NEW LANE	scarboro ave	P	9
New Ln	e/of courtney l|e/of scarboro a|e/of bay st|w/of bay st|s/of bay st	T	177
New St	n/of jewett ave|w/of heberton|w/of jewett ave|e/of heberton av|e/of heberton a|e/of port richm|e/of port richmo|e/of heberton|n/of port richm|w/of park ave|e/of park ave|w/of jewett av|s/of port richm|w/of heberton a|w/of port richm|n/of port richmo|w/of port richmo|e/of jewett ave	T	479
NEW ST		P	4
New York Ave	s/of college av|n/of college av|s/of kingsley a	T	6
Newark Ave	w/of morningsta	T	32
NEWARK AVENUE		S	6
Newberry Ave		T	12
NEWBERRY AVE		P	4
Niagara St	e/of seneca ave|e/of clove rd|w/of clove rd	T	29
Nicholas Ave	e/of slaight st|e/of charles ave|n/of harrison a|n/of blackford|e/of richmond t|s/of charles av|e/of blackford a|n/of st marks pl|w/of st marks p|s/of richmond t|e/of castleton|s/of carroll pl|e/of blackford	T	172
NICHOLAS AVE		P	8
Nicholas St	w/of carroll pl|w/of st marks|s/of st marks pl|e/of st marks pl|n/of st marks p|s/of carroll pl|w/of st marks pl|n/of carroll pl|w/of st marks p|e/of st marks p|e/of richmond t|e/of carroll pl|s/of richmond t	T	138
Nightingale St		T	8
Niles Pl		T	6
Nippon Ave	w/of lamont ave|w/of sinclair a|e/of lamont ave|s/of stafford a	T	36
Nixon Ave		T	28
Noble Pl	n/of state st|w/of broadway|e/of broadway|e/of state st|w/of state st|s/of state st	T	38
Noel St		T	11
Nome Ave	e/of merrymount|e/of bridgetown|s/of steinway a|e/of lewiston s|n/of merrymount|s/of lewiston s|w/of elie ct|s/of bridgetown|w/of turf rd|e/of adam ct|w/of turf ct|w/of bridgetown|w/of merrymount|e/of turf rd|s/of turf ct|w/of adam ct|w/of bridgetow|w/of shale st|w/of kelly blvd|n/of kelly blvd|w/of lewiston s|e/of lewiston|e/of kelly blvd|n/of bridgetown|s/of turf rd|s/of bridgetow|n/of turf rd|e/of vassar st|e/of rockne st|s/of purdue ct	T	295
NOME AVE		P	4
Norden St	w/of richmond rd	T	14
Norma Pl	w/of metropolit	T	17
Normalee Rd		T	8
Norman Pl	w/of case ave|e/of case ave|n/of case ave	T	22
North Ave		T	10
North Burgher Ave	s/of morrison a|n/of e raleigh|s/of richmond te|n/of castleton|e/of castleton a	T	47
NORTH BURGHER AVENUE		S	10
North Railroad Ave	w/of locust ct|e/of emmet ave|e/of stobe ave	T	25
Northern Blvd		T	9
Northfield Ave	n/of macormac p|n/of kinsey pl|n/of arlington|e/of forest ave|s/of macormac pl|n/of forest ave|s/of macormac p|e/of macormac p	T	118
NORTHFIELD AVE	c/o kingsley pl|c/o kingsley ave	P	6
NORTHFIELD AVENUE		S	5
Norwalk Ave	n/of manor rd|e/of manor rd|w/of bay st|s/of kermit ave|n/of kermit ave	T	29
NORWAY AVE		P	11
Norway Ave	n/of kermit ave|s/of hylan blvd|w/of kermit ave|s/of reid ave|s/of kermit ave|e/of kermit ave|n/of reid ave|e/of mcclean ave	T	95
Norwood Ave	w/of bay st|s/of bay st|e/of bay st	T	38
Nostrand Ave		T	16
Notre Dame Ave	e/of wilson ave	T	30
Notus Ave	e/of woehrle ave	T	27
NOTUS AVE	drumgoole rd|drumgoole rd s	P	4
Nugent Ave	w/of liberty a|w/of seaview ave|n/of seaview av|w/of norway ave|s/of liberty av|w/of jefferson|w/of liberty ave|s/of slater blv|e/of naughton a|e/of dongan hill|w/of seaview av|n/of buel ave|s/of adams ave|w/of liberty av|n/of slater blv|s/of seaview av|e/of buel ave|w/of dongan hi|w/of buel ave|s/of mason ave|e/of liberty av|n/of slater bl|n/of norway ave|e/of liberty ave|e/of seaview av|s/of naughton a|w/of dongan hil|s/of buel ave|w/of slater blv|e/of seaview ave|e/of slater blv|s/of liberty ave|e/of dongan hil|e/of dongan hi	T	229
NUGENT AVE		P	5
Nugent St		T	7
Nunley Ct	s/of vanderbilt	T	22
Nutwood Ct		T	5
O Connor Ave	n/of victory bl|w/of victory bl	T	18
O Gorman Ave	e/of redgrave a|n/of ainsworth|e/of ainsworth|n/of cranford|e/of fieldway a|e/of cranford s|e/of spratt ave|s/of taunton st|n/of cranford st|w/of keegans ln|n/of cranford s|w/of taunton st|s/of ainsworth|w/of fieldway a|e/of cranford a|e/of bay ter|s/of bartow st	T	61
Oak Ave	w/of s railroad	T	73
OAK AVE		P	5
Oak St	w/of st marys av|e/of bell st	T	9
Oakdale Ave	e/of winchester|e/of richmond a|e/of ridgecrest|s/of forest ave	T	24
Oakdale St	e/of ridgecrest|e/of pacific av|w/of preston av|e/of pacific a	T	51
OAKLAND AVE		P	6
Oakland Ave	w/of forest ave|s/of forest ave|s/of bement ct|n/of castleton a|n/of forest ave|n/of forest ct	T	361
OAKLAND AVENUE		S	4
Oakley Pl		T	6
Oakville St	w/of washington|e/of washington|n/of fields ave	T	67
OAKVILLE ST		P	5
Oakwood Ave	n/of forest ave|s/of forest ave	T	23
Oban St		T	8
Oberlin St		T	29
Occident Ave	e/of sunrise te	T	24
Ocean Ave	e/of mcclean av|s/of mcclean av	T	87
Ocean Ter	e/of milford d|w/of milford av|e/of witteman pl|w/of milford a|e/of narrows r|n/of milford ave|s/of witteman p|w/of witteman p|s/of milford av|w/of milford dr|e/of witteman p	T	65
Oceanic Ave	s/of hylan blv|s/of hylan blvd|w/of hylan blvd|e/of hylan blvd	T	46
OCEANSIDE AVE		P	11
Oceanside Ave	s/of seaview av|s/of naughton|e/of naughton a|s/of sand ln	T	53
OCEANSIDE AVENUE		S	7
Oceanview Ave		T	8
Oceanview Pl	s/of armstrong a	T	6
Oder Ave	s/of pierce st|e/of palma dr|s/of palma dr|s/of baltic ave|s/of narrows rd|w/of steuben st	T	84
ODER AVE		P	6
Ohio Pl	e/of constant a|n/of constant|n/of constant a	T	17
Old Amboy Rd	s/of amboy rd|w/of st albans|w/of amboy rd|n/of amboy rd|e/of amboy rd|e/of st albans	T	137
Old Town Road	e/of durgess st|n/of durgess st|n/of providence|s/of durgess st|n/of laconia av|w/of hylan blvd|s/of providence|e/of hylan blvd|w/of providence|w/of durgess st	T	51
Oldfield St		T	8
Olga Pl	e/of hylan blv|e/of pouch ter|w/of hylan blvd|e/of hylan blvd	T	13
Oliver Pl		T	12
Olympia Blvd	e/of andrews st|n/of seaview av|s/of liberty av|n/of liberty ave|n/of buel ave|e/of slater blv|e/of seaview ave|w/of liberty av|e/of seaview av|w/of seaview ave|e/of liberty ave|s/of seaview av|w/of buel ave|n/of hylan blvd|e/of liberty av|w/of slater blv|w/of seaview av|s/of seaview ave|w/of liberty ave|s/of liberty ave|e/of buel ave|n/of seaview ave|n/of liberty a|w/of seaview a|s/of liberty a|n/of liberty av|w/of naughton a|e/of liberty a	T	553
OLYMPIA BLVD		P	13
Oneida Ave	n/of tioga st|s/of oswego st	T	56
Ontario Ave	e/of victory bl|n/of schoharie s|s/of schoharie|s/of tioga st	T	29
Opp Ct	w/of ridgewood	T	6
Orange Ave	w/of riley pl|w/of port richmo|s/of decker ave|e/of port richm|s/of port richmo|n/of decker ave	T	73
Orchard Ln		T	6
Ordell Ave		T	10
Orinoco Pl		T	10
Orlando St	e/of olympia bl	T	9
Ormond Pl		T	7
Ormsby Ave	w/of keating st|n/of keating st	T	15
Osborn Ave	n/of david st|n/of russell st|w/of preston av|w/of russell st|n/of driggs st|w/of hylan blv|n/of hylan blvd|w/of hylan blvd|n/of hylan blv|e/of russell st|e/of hylan blvd|s/of hylan blvd	T	34
Osborne St	w/of preston av|e/of preston av	T	12
Osgood Ave	s/of vanderbilt|s/of greenfield|e/of gordon st|e/of van duzer|s/of fairway ave|w/of park hill a|e/of park hill|s/of park hill a|s/of targee st|n/of vanderbilt|e/of vanderbil|w/of fairway ave|n/of park hill|w/of targee st|s/of van duzer|w/of van duzer|w/of park hill|w/of vanderbilt|e/of vanderbilt|s/of park hill|w/of greenfield|n/of van duzer	T	271
OSGOOD AVE		P	8
Oswego St	s/of logan ave|n/of logan ave|e/of labau ave|e/of seneca ave|w/of logan ave|w/of clove rd	T	32
Other-See Comments	staten iland ferry l|navy peir ct|park drive north|st george ferry|s/of beresford|ferry si lot|francher pl|si ferry terml|fancher pl|ganevoort blvd|si ferry lot 1|ferry lot one|housman ave|ferry termnal dr|ferry  lot one|ferry lot|si ferry terminal|9 st|ferry terminal|w/of alberta av|8 st|ferry teinal dr|ferry|st george ferry lot|arron ln|goethals rd n|shelley ave|ferey lot|st georfe ferry lot|si ferry lot|navy pier ct|si crt hse|mac grecor st|si feeey lot|st george|navy pier|durges  st|st ferry lot|e/of eltingvill|si court house|durges st|barb st|staten island court|ave b|aaron ln|si ferry parking ter|coryn ct|si court house lot|staten island ferry|navy pier court|housman av|si ferry parking lot|ferry terminal dr|west service road|saint marks pl|ferrt lot|e/of tompkins ct|e/of jules dr|court house lot|staten island mall|si ferey lot|si court hse|7 navy pier ct|w/of roswell av|navy crt|kinsley pl|housman|navy pier courts|si  ferry parking lo|feery lot|si courthouse|navy peir court|court house|navy pier   ct|s ferry lot|ferrynlot|arron lane|no pine terr|bayview lane|ferrylot|navy pier  court	T	2968
Otis Ave	s/of hylan blvd|n/of hylan blvd	T	45
OTIS AVE		P	7
Outerbridge Ave		T	12
Overlook Ave	n/of delaware s|w/of delaware s|e/of delaware s	T	14
Overlook Ter		T	14
Ovis Pl		T	10
Oxford Pl	n/of cebra ave|e/of cebra ave|w/of woodstock a|n/of castleton a|s/of woodstock|w/of cebra ave|s/of cebra ave|s/of castleton|s/of woodstock a	T	126
OXFORD PL		P	6
Pacific Ave		T	29
Page Ave	e/of estelle pl|n/of haywood st|s/of haywood s|n/of eastwood a|e/of amboy rd|e/of arthur kil|e/of bartow ave|w/of bartow st|s/of eastwood a|w/of bartow ave	T	82
PAGE AVE		P	4
Palma Dr	e/of oder ave|n/of park hill a|e/of hanover ave|n/of hanover ave|s/of hanover ave|e/of park hill|w/of park hill a|w/of oder ave|w/of hanover ave|n/of hanover av|s/of park hill|e/of targee st|w/of hanover av|w/of park hill|e/of park hill a|e/of hanover av|s/of hanover av|w/of targee st	T	207
Palmer Ave	n/of hanover av	T	33
Parish Ave	n/of victory bl|n/of victory blv	T	31
Park Ave	s/of richmond t|s/of new st|e/of vreeland s|s/of bennett st|n/of church st|s/of castleton c|n/of vreeland s|s/of church st|w/of new st|w/of castleton|w/of vreeland s|w/of richmond te|w/of richmond t|e/of bennett st|n/of bennett st	T	265
PARK AVE	church st	P	19
PARK AVENUE		S|P	33
Park Ct		T	7
Park Dr	north|s/of signs rd	T	12
PARK HILL		P	4
Park Hill Ave	n/of park hill|n/of sobel ct|n/of osgood av|n/of osgood ave|e/of sobel ct|n/of park hill l|w/of sobel ct|w/of park hill l|n/of palma dr|s/of park hill|s/of palma dr|s/of sobel ct|s/of osgood av|s/of osgood ave|e/of park hill|w/of osgood ave|w/of park hill|e/of park hill l|s/of park hill l	T	1490
PARK HILL AVE	sobel	P	28
Park Hill Cir	e/of osgood ave|s/of osgood ave|e/of park hill|s/of palma dr|n/of osgood ave	T	56
Park Hill Ct	e/of vanderbilt	T	41
Park Hill Ln	n/of fairway ave|s/of park hill|e/of park hill|s/of park hill a	T	76
Park Ln	w/of park hill	T	4
Park Pl	w/of highview a	T	20
Park Rd	w/of richmond a|w/of ridgecrest|e/of richmond av	T	6
Park St	n/of maplewood a	T	52
Park Ter	e/of lindenwood	T	8
Parker St		T	8
Parkinson Ave	w/of kramer st|w/of hylan blvd|s/of fayette av|s/of lamport bl|s/of kramer st|e/of reid ave|n/of reid ave|n/of fayette ave|w/of kermit ave|s/of kermit ave|n/of mccormick|n/of winfield a|w/of winfield a|s/of ledyard pl|s/of winfield a|s/of hylan blvd|n/of kermit ave|n/of ledyard pl|e/of winfield a|w/of mccormick|n/of hylan blvd|s/of mccormick p|w/of ledyard pl|e/of hylan blvd|s/of mccormick|e/of winfield av|e/of ledyard pl|w/of reid ave|n/of leslie ave|n/of kramer st|w/of fayette av	T	268
Parkwood Ave	n/of wheeling a|w/of ashland av|e/of ashland av|e/of bradford a|s/of bradford	T	10
Patten St	w/of hopping av|s/of hopping av	T	10
PATTERSON AVE		P	15
Patterson Ave	e/of lincoln av|e/of winfield a|e/of winfield st|w/of winfield s|e/of winfield s|w/of winfield|n/of winfield st|s/of dongan hill|w/of seaview av|e/of winfield av|w/of vulcan st|n/of winfield s|e/of naughton a|s/of seaview av|s/of dongan hil|s/of winfield st	T	90
Paulding Ave		T	30
Pauw St	n/of jersey st|e/of york ave|w/of jersey st	T	14
Peare Pl	s/of hylan blvd|n/of hylan blvd|w/of bayview te|w/of hylan blvd	T	31
Pearl St		T	11
Pearsall St	e/of olympia bl	T	19
Pearson St		T	8
Pelton Ave	w/of whitewood|w/of castleton|s/of castleton a|n/of castleton a|s/of forest av|n/of forest ave|e/of forest ave|w/of morrison a|w/of forest av|s/of forest ave|s/of castleton|n/of forest av|n/of castleton|e/of forest av|w/of forest ave	T	562
Pelton Pl	e/of pelton ave|n/of forest ave|s/of forest ave	T	5
Pemberton Ave	s/of gurley ave	T	9
Penbroke Ave		T	29
Pendale St	n/of fairbanks|e/of malone ave|n/of montreal av|s/of malone ave|n/of chesterton|s/of fairbanks|e/of fairbanks|n/of guyon ave|n/of fairbanks a|w/of malone ave|w/of guyon ave|w/of fairbanks|e/of montreal a|w/of malone av|w/of montreal a|w/of montreal av|n/of chesterto	T	55
Pendleton Pl	e/of prospect a|w/of prospect av|n/of arnold st|w/of prospect a	T	41
Penn Ave	w/of 8th st|n/of hylan blv|n/of hylan blvd|n/of 10th st	T	29
Penn St	w/of gower st|n/of gower st	T	26
Penton St	e/of amboy rd	T	10
Percival Pl		T	4
Perkiomen Ave		T	7
Perry Ave	s/of victory blv|e/of victory bl|s/of victory bl	T	44
Pershing St	e/of linwood ave	T	5
Peru St		T	6
Peter Ave	s/of clawson st|s/of clawson s|n/of clawson st	T	24
Petrus Ave	s/of rye ave|e/of rye ave|e/of moffett st|e/of chesebroug|s/of chesebroug|n/of rye ave|e/of richmond av|w/of richmond av|e/of chesebrou|e/of moffett s	T	93
Pheasant Ln		T	6
Phelps Pl		T	7
Philip Ave	n/of lynch st|s/of hylan blvd|s/of hylan blv|s/of allegro st	T	25
Piave Ave	s/of mcclean av	T	23
Piedmont Ave	n/of hylan blvd|e/of hylan blvd|s/of hylan blvd|w/of hylan blv	T	44
PIEDMONT AVE		P	7
Pierce St	e/of hanover av|e/of targee st|e/of richmond r|s/of neckar ave|w/of oder ave|w/of targee st|e/of britton av|w/of britton av|w/of neckar ave|s/of rhine ave|s/of richmond r|e/of elbe ave	T	51
Pike St		T	23
Pilcher St	e/of forest hil	T	5
Pine Pl	n/of vanderbilt|n/of coursen pl	T	14
Pine St		T	55
Pine Ter		T	4
Pinewood Ave	s/of maplewood a	T	18
Pitney Ave	e/of gladwin st|e/of gaynor st	T	58
Pittsville Ave	e/of swinnerton|s/of swinnerton|e/of swinnerto|w/of swinnerton|s/of yetman ave|s/of brighton s|e/of amboy rd|e/of yetman ave	T	26
Plank Rd		T	29
Platinum Ave	w/of forest hi|w/of lott ln|e/of lott ln|e/of forest hi|e/of forest hil|w/of forest hil|s/of lott ln|w/of richmond a	T	19
Platt St	w/of fairbanks|e/of champlain|w/of champlain|e/of fairbanks|e/of fairbanks a	T	28
Plattsburg St	e/of alter ave|n/of seaview av|e/of seaview av|w/of cromwell av|w/of cromwell|s/of cromwell a	T	29
Pleasant Pl	w/of vanderbilt|s/of coursen pl|e/of coursen pl	T	11
Pleasant Plains Ave		T	59
Pleasant Valley Ave	w/of van duzer|n/of van duzer|s/of van duzer	T	112
PLEASANT VALLEY AVE		P	8
Plymouth Rd	s/of rivington|w/of rockville	T	29
Poets Cir	s/of carlyle gre|w/of carlyle gre	T	8
Poillon Ave	e/of amboy rd|n/of newton st|e/of annadale r	T	22
Poland Pl	w/of laguardia|w/of todt hill r	T	30
Pompey Ave	s/of stroud ave|s/of leverett|n/of augusta a|n/of katan ave|s/of leverett a|w/of stroud ave|n/of scranton a|s/of genesee av|s/of augusta av|n/of leverett av|w/of leverett av|w/of laredo ave|n/of laredo av|e/of adlai cir|s/of scranton a|s/of katan ave|s/of laredo ave|w/of leverett a|e/of katan ave|e/of stroud ave|e/of bent st|e/of figurea av|n/of stroud ave|n/of figurea av|n/of figurea a|e/of augusta av|e/of genesee ave|s/of leverett av	T	112
POMPEY AVE	marne ave	P	15
POMPEY AVENUE		P|S	4
Pond St	w/of alverson a	T	16
Pontiac St	n/of forest ave|s/of forest ave	T	17
Poplar Ave	e/of rossville	T	22
Port Richman Avenue		T	122
Port Richmond Ave	s/of catherine s|n/of church st|n/of hatfield p|s/of hatfield p|w/of grove st|w/of grove ave|n/of vreeland s|w/of van riper|w/of harrison a|n/of richmond te|w/of blackford|w/of forest ave|n/of richmond t|w/of maple ave|e/of grove st|s/of vreeland st|e/of vreeland s|w/of harrison av|e/of harrison av|w/of vreeland|w/of vreeland s	T	3419
PORT RICHMOND AVE	richmond terr	P	20
Portage Ave	w/of mountainv|w/of fanning st|w/of mountainvi|e/of fanning st|w/of wellbrook|e/of mountainvi|w/of livingston|w/of melba st|w/of manor rd|e/of gower st|e/of wellbrook|w/of gower st|w/of mountainvie|e/of bradley av	T	81
Portland Pl		T	12
Posen St	w/of lorraine|w/of bath ave	T	8
Post Ave	w/of heberton av|w/of port richm|e/of heberton a|w/of decker ave	T	321
POST AVE		P	11
Post Ln		T	11
Potter Ave	e/of manor rd|w/of manor rd|w/of royal oak	T	50
POTTER AVE		P	6
Pouch Ter		T	29
Poultney St		T	12
Powell St	n/of covington|n/of w castor p	T	25
Prall Ave	n/of deisius st|e/of deisius st	T	77
Pratt Ct	s/of cody pl|e/of cody pl	T	12
Prescott Ave		T	5
President St	e/of birchard av	T	14
Presley St	w/of nelson ave	T	15
Preston Ave		T	44
Prices Ln		T	10
Primrose Pl	w/of tysens ln	T	30
Prince St	w/of vanderbilt|e/of wiederer p|e/of vanderbilt	T	46
Princess St		T	14
Princeton Ave	s/of colgate pl	T	31
Princeton Ln		T	4
Princewood Ave		T	14
Prol Pl	w/of richmond av|w/of richmond a	T	6
Prospect Ave	w/of harvard av|w/of sumner pl	T	75
PROSPECT AVE		P	4
Prospect Pl	w/of amboy rd|n/of amboy rd	T	11
Prospect St	w/of van duzer|s/of van duzer|w/of bay st|e/of van duzer|e/of bay st|e/of van duzer s|w/of front st|n/of bay st|e/of front st|s/of van duzer s|s/of bay st	T	469
PROSPECT ST		P	4
PROSPECT STREET		P|S	4
Providence St	w/of bay st|e/of old town r	T	38
PT RICHMOND AVE		P	4
Pulaski Ave	n/of hooker pl|n/of ronald ave|w/of dixon ave|e/of hooker pl|e/of dixon ave|s/of hooker pl|n/of dixon ave	T	244
Purcell St	e/of broadway|w/of broadway	T	46
Purdue St	w/of nome ave|s/of nome ave	T	22
Purdy Ave	e/of gansevoort|w/of sheraden|w/of gansevoort|w/of byrne ave|w/of woolley av|e/of sheraden a|e/of bradley av|e/of woolley av|w/of carmel ave|n/of clermont p|n/of carmel ave|w/of wheeler av|e/of crafton av|e/of gansevoor|e/of bradley a|w/of mann ave|w/of martin ave	T	91
Purdy Pl	e/of byrne ave	T	29
Purroy Pl	e/of targee st|n/of targee st	T	16
Quail Ln		T	4
Queen St	e/of gower st|e/of melba st|s/of fanning st|s/of elvin st|e/of bradley av|e/of elvin st|e/of wellbrook a|w/of gower st|e/of fanning st|e/of suffolk av|n/of fanning s	T	74
QUEEN ST		P	4
Queensdale St	s/of ashland av	T	6
Quincy Ave		T	4
Quinlan Ave	s/of victory bl|s/of victory blv	T	34
Quinn St	w/of broad st|s/of broad st|w/of tompkins s|n/of tompkins s|s/of tompkins st|s/of tompkins s|n/of tompkins st	T	79
QUINN ST		P	21
Quintard St	n/of ledyard pl|s/of hylan blvd|s/of hylan blv|e/of ledyard pl|s/of jerome rd|w/of laconia av|n/of jerome rd	T	199
QUINTARD STREET		S	27
Radcliff Rd		T	54
Radford St	s/of klondike|s/of klondike av	T	81
Radigan Ave		T	10
Railroad Ave	s/of mcclean av|n/of mcclean ave|s/of cedar ave	T	25
RAILROAD AVE		P	11
Raily Ct	s/of alcott st|e/of huguenot|s/of huguenot a|e/of alcott st|e/of huguenot a	T	22
Rainbow Ave	w/of heberton a	T	29
Ralph Ave		T	11
Ralph Pl		T	14
Ramapo Ave	w/of marcy ave	T	67
Ramble Rd		T	5
Ramona Ave	e/of maguire a|e/of maguire av|e/of helene ct|w/of maguire a|s/of helene ct|e/of minturn av|w/of helene ct	T	167
RAMONA AVE		P	20
RAMSEY PL		P	4
Randall Ave	s/of castleton	T	8
Rankin St		T	4
RARITAN AVE	henry pl|johnson place	P	10
Raritan Ave	s/of hylan blvd|s/of laconia av|w/of hylan blvd|w/of richmond r|n/of hylan blvd|e/of laconia av|e/of hylan blvd|n/of laconia av|e/of hylan blv|n/of laconia ave	T	232
RATHBUN		P	4
Rathbun Ave	e/of foster rd|w/of delmar ave|e/of grantwood|e/of heenan ave|n/of huguenot a|n/of delmar ave|w/of ellsworth|s/of maguire ave	T	280
RATHBUN AVE		P	17
Ravenhurst Ave	e/of jewett ave|w/of manor rd|e/of karen ct	T	46
Ravenna St		T	4
Ray St	w/of van brunt	T	5
Raymond Ave	n/of victory bl|n/of victory b|n/of forest ave|s/of victory bl|w/of victory bl|e/of victory bl|s/of victory blv	T	43
Raymond Pl	n/of delafield|s/of delafield a|n/of forest ave|s/of forest ave	T	59
Reading Ave		T	19
Rector St	w/of richmond te|s/of richmond t|w/of richmond t|s/of richmond te	T	78
Redgrave Ave	s/of maybury ct|w/of greencroft|e/of durant ave|w/of maybury ct|n/of maybury ct|n/of hylan blvd	T	43
Redwood Ave	w/of sandalwoo|w/of sandalwood|e/of evergreen s|e/of sandalwood	T	27
Regan Ave	s/of forest ave	T	8
Regent Cir		T	8
Regis Dr	w/of lenore ct|e/of elson ct|s/of farragut av	T	113
REGIS DR		P	6
REGIS DRIVE		P	12
Reid Ave	n/of jerome ave|n/of jerome rd|e/of laconia av|e/of jerome rd|n/of hylan blvd|w/of laconia av|e/of hylan blvd|s/of oberlin st|w/of oberlin s|n/of laconia av|w/of jerome rd|s/of jerome rd|s/of hylan blvd	T	99
Remsen St		T	16
Renee Pl	e/of lander ave|w/of lander ave|e/of hillman av|n/of lander ave|w/of hillman av|s/of lander ave|e/of kirshon av|s/of lander av|n/of hillman av	T	37
Renfrew Pl	e/of bowles ave|s/of bowles ave|n/of richmond av	T	30
Reno Ave	w/of hylan blvd	T	10
Rensselaer Ave	w/of foster rd|n/of lenevar av|s/of ellsworth|e/of foster ave|w/of nippon ave|w/of jefferson b|e/of huguenot a|w/of delmar ave|s/of marcy ave|n/of vernon ave|e/of lenevar ave	T	174
RENSSELAER AVE		P	6
Renwick Ave	e/of little cl|s/of victory blv|w/of little clo	T	21
Reon Ave	w/of manor rd|w/of todt hill|e/of todt hill|w/of sommers ln|e/of manor rd	T	13
Retford Ave		T	40
Retner St		T	4
Revere St	e/of sharon ave|w/of university	T	36
Reynolds St	s/of hylan blvd	T	29
REYNOLDS ST		P	4
Rhett Ave		T	13
Rhine Ave	e/of pierce st|n/of baltic ave|s/of clove rd|e/of baltic ave|e/of dekalb st|s/of steuben st	T	74
Rice Ave		T	25
Richard Ave		T	86
RICHARD AVENUE		S	4
Richard Ln	n/of gary ct|w/of morani st	T	39
Richmond Ave	n/of regis dr|s/of hylan blv|e/of scranton a|n/of forest st|s/of merrill ave|s/of regis dr|n/of croft pl|e/of sumner ave|n/of eton pl|s/of melissa st|e/of carnegie a|s/of vedder ave|n/of signs rd|n/of anita st|w/of willow rd|n/of katan ave|w/of forest st|e/of prol pl|s/of sumner ave|s/of vedder av|s/of merrymount|w/of ada dr|s/of shirley ave|n/of vedder ave|w/of morningsta|s/of gurley ave|n/of hylan blvd|s/of jardine av|w/of lamberts|n/of marc st|s/of sylvia st|e/of hylan blv|n/of sylvia st|e/of oakdale av|n/of prol pl|staten island mall|w/of vedder ave|e/of regis dr|s/of renfrew pl|n/of renfrew pl|w/of oakdale av|e/of morningsta|n/of wilson ave|n/of park rd|e/of peter st|e/of arlene st|s/of armand st|n/of king st|n/of rockland a|s/of oakdale st|s/of ada dr|s/of amboy rd|s/of morningsta|e/of oakdale st|s/of victory bl|w/of hylan blvd|s/of madan ct|n/of ada dr|e/of renfrew pl|w/of lander ave|s/of oakdale s|e/of hylan blvd|n/of oakdale st|n/of figurea av|s/of koch blvd|s/of park rd|s/of hylan blvd|rear side|s/of peter st|e/of anita st|w/of peter st|e/of federal pl|n/of melissa st|n/of shirley av|e/of gurley ave|s/of spring st|e/of willow rd|w/of regis dr|w/of greentree|n/of koch blvd|w/of anita st	T	12512
RICHMOND AVE	ifo shakeshek|holiday way|tommy tavern|vedder ave|anita st	P	222
RICHMOND AVENUE		P|S	41
RICHMOND HILL RD	northport lane	P	23
Richmond Hill Rd	e/of rockne st|n/of kelly blvd|e/of vassar st|w/of golf view|s/of kelly blvd|w/of kelly blvd|w/of ring rd|e/of brunswick|w/of lamped loo|w/of saturn ln|w/of merrymount|w/of marsh ave|n/of kelly blv|e/of kelly blvd|s/of brunswick|e/of ring rd	T	222
RICHMOND HILL ROAD		P|S	10
Richmond Rd	s/of spring st|w/of dongan hil|w/of liberty av|w/of van name a|s/of narrows rd|w/of quintard s|e/of beacon pl|n/of spring st|e/of barton ave|s/of ralph pl|e/of spring st|w/of raritan av|w/of adams ave|n/of steuben st|n/of ralph pl	T	982
RICHMOND RD		P	22
RICHMOND ROAD		P|S	13
Richmond Ter	e/of mersereau|w/of nicholas s|e/of nicholas a|s/of federal pl|e/of snug harbo|w/of jersey st|e/of federal pl|e/of st peters|w/of holland av|e/of newark ave|s/of nicholas st|e/of schuyler st|w/of federal p|e/of st peters p|n/of holland a|w/of betty ct|w/of federal pl|e/of jewett ave|w/of de hart ave|e/of post ln|w/of northfield|w/of lockman av|w/of john st|w/of simonson a|s/of federal p|e/of holland a|s/of andros ave|w/of schuyler st|e/of holland av|s/of schuyler st|w/of holland a|e/of jersey st|s/of betty ct|e/of schuyler s|w/of schuyler s|s/of st peters p|s/of schuyler s|e/of federal p|n/of federal p|n/of st peters p|s/of st peters|w/of st peters|s/of rector st|s/of holland av|n/of betty ct|e/of westervelt|e/of stuyvesant|n/of st peters|e/of port richmo|e/of van pelt a|n/of federal pl|s/of holland a|w/of greentree	T	1209
RICHMOND TER	stuyvesant	P	26
RICHMOND TERR	clinton ave|elizabeth	P	145
RICHMOND TERRACE	federal place	S|P	72
Richmond Valley Rd	e/of page ave	T	5
RICHMOND VALLEY RD		P	4
Ridge Ave		T	18
Ridgecrest Ave	n/of hylan blvd|s/of crest loop|n/of hylan blv	T	60
Ridgeway Ave	e/of victory blv|w/of riche ave|n/of victory bl|e/of victory b|e/of victory bl|s/of victory bl|s/of victory b|w/of victory bl	T	27
Ridgewood Ave	s/of gil ct|s/of lamoka ave|n/of wilson ave|n/of gil ct|n/of katan ave|e/of wilson ave|s/of arthur kil	T	150
Ridgewood Pl	s/of castleton|w/of castleton|s/of castleton a|n/of forest ave	T	30
Riedel Ave	n/of tysens ln|s/of windemere|n/of park st|n/of windemere|s/of e broadway	T	31
Riegelmann St	e/of willowbroo	T	28
Riga St	e/of adelaide	T	44
Riley Pl	e/of orange ave|s/of orange ave|n/of orange ave	T	28
Rivington Ave	w/of richmond a|w/of richmond|n/of freedom a|e/of richmond a|e/of mulberry a|w/of mulberry a|e/of park dr|w/of freedom av|n/of mulberry av|s/of mulberry ci|e/of freedom av	T	39
Roanoke St	s/of washington|e/of washington|n/of washington	T	25
Roberts Dr		T	20
Robin Rd	e/of arthur ave|s/of arthur ave|e/of sand ln|w/of sand ln|n/of ocean ave	T	51
ROBIN RD		P	4
Robinson Ave	n/of hylan blvd|n/of king st	T	59
Rochelle Pl		T	6
Rockaway St	n/of hylan blvd	T	36
Rockland Ave	e/of cooper ave|n/of cooper ter|w/of grissom av|w/of cooper pl|s/of cooper ter|e/of cooper ter|e/of richmond a|w/of cooper ter	T	157
ROCKLAND AVE		P	6
ROCKLAND AVENUE		S|P	5
Rockne St	s/of nome ave|w/of nome ave|e/of nome ave	T	51
Rockville Ave	e/of mulberry av	T	49
Rockwell Ave		T	7
Roderick Ave	w/of hylan blv	T	13
Roe St	s/of cary ave	T	48
Roff St	e/of van duzer|e/of targee st|w/of vanderbilt|n/of vanderbilt	T	104
Rokeby Pl	e/of bard ave|s/of bard ave	T	23
Rolling Hill Green		T	30
Roma Ave	w/of new dorp l|w/of navesink pl|n/of tysens ln|w/of tysens ln|e/of tysens ln|w/of ebbitts st	T	46
Roman Ave	e/of seldin ave|w/of may ave|w/of arlene st|e/of arlene st|w/of seldin ave|s/of seldin ave	T	96
Rome Ave	w/of stanwich st|s/of targee st|e/of targee st|w/of targee st	T	72
Ronald Ave	w/of morningsta|s/of morningsta	T	16
RONALD AVE		P	10
ROOSEVELT AVE		P	10
Roosevelt Ave	e/of harold st|n/of harold st	T	120
Roosevelt St	s/of baltic ave|e/of baltic st	T	11
ROOSEVELT ST		P	19
Rose Ave	s/of 1st st|n/of new dorp pl|n/of new dorp p|n/of hylan blv|n/of 3rd st|n/of 1st st|n/of 8th st|s/of 9th st|e/of 9th st|s/of new dorp pl|s/of 3rd st|s/of richmond r|s/of new dorp p|e/of 1st st|e/of new dorp p|e/of hylan blvd|e/of richmond r|w/of new dorp p	T	371
ROSE AVENUE		P	4
Rose Ct		T	4
Rosebank Pl		T	12
Rosecliff Rd	n/of birch rd|w/of birch rd|s/of spartan ave|s/of spartan a	T	45
Rosedale Ave	e/of everton av|e/of belfield|n/of belfield a|s/of belfield|e/of huguenot a|e/of belfield a|w/of belfield|w/of belfield a|s/of belfield a|e/of holcomb ave	T	77
ROSEWOOD PL		P	5
Rosewood Pl		T	47
Ross Ave	e/of 8th st|s/of 10th st|w/of 9th st|s/of 4th st|s/of 9th st|s/of 2nd st|n/of 9th st|n/of new dorp p|n/of 1st st|n/of new dorp pl	T	87
Rossville Ave	n/of grafe st|n/of mason blvd|s/of gunton pl|s/of mason blv|e/of berry ct|s/of barrow pl|w/of grafe st|e/of gunton pl|s/of barry st|s/of knesel st|s/of pond st	T	85
Roswell Ave	s/of victory bl|e/of victory bl|n/of victory bl|n/of wild ave|e/of wild ave|w/of victory bl	T	42
Row Pl		T	7
Roxbury St	e/of lockman av|s/of lockman av|w/of grandview|n/of lockman av	T	237
ROXBURY ST		P	14
ROXBURY STREET		P	4
Royal Oak Rd		T	6
Rugby Ave	s/of ridge ct	T	32
Rupert Ave	w/of washington|e/of washington|n/of washington|e/of fields ave	T	63
Russek Dr		T	61
RUSSEK DRIVE		S|P	6
RUSSELL DRIVE		P	4
Russell St	s/of wiman ave|e/of osborn ave	T	23
Rustic Pl	e/of nelson ave|n/of nelson ave	T	9
Ruth Pl		T	21
Ruth St	w/of livermore|w/of livermore a|s/of livermore	T	9
Ruxton Ave	w/of woodrow rd|w/of woodrow r|e/of woodrow r	T	58
Ryan Pl		T	18
Rye Ave	w/of pompey ave	T	32
S Beach Ave	s/of olympia b	T	11
S Bridge St	w/of arthur kil	T	37
S Gannon Ave	w/of gansevoort|w/of melba st|e/of woodward a|n/of legion pl|w/of ingram ave|w/of woodward a|w/of clermont p|e/of buchanan a|w/of collfield a|w/of kell ave|w/of collfield|w/of fanning st|s/of collfield|s/of melba st|e/of fanning st|e/of ardmore ave|s/of fanning st|w/of mann ave|e/of collfield a|w/of quinlan av|s/of gower st	T	77
S Goff Ave	n/of kenneth pl|n/of latourette	T	37
S Greenleaf Ave	s/of coale ave|s/of goodell av|e/of chandler a|n/of victory bl|w/of chandler a|s/of victory blv|n/of crowell av|s/of goodell ave|s/of chandler a|e/of chandler av|n/of chandler a|n/of coale ave|s/of victory bl|w/of chandler av|n/of maine ave|e/of coale ave	T	56
S Railroad Ave	s/of prescott a|s/of colfax ave|e/of bache ave|w/of bancroft a|e/of bancroft a|s/of fremont av|s/of bache ave|w/of jefferson|e/of fremont av|s/of midland av|w/of colfax ave|w/of cannon blv|e/of greeley a|e/of lincoln av|w/of guyon ave|e/of princeton|s/of cannon blv|e/of oak ave|w/of kelvin ave|w/of jacques ave|e/of guyon ave|e/of prescott a|e/of hull ave|e/of midland av|w/of justin av|w/of reno ave|w/of princeton|s/of bancroft a|s/of lincoln av|n/of colfax ave|e/of bay ter|e/of penn ave|w/of clarence p|w/of bache ave|n/of bay ter|w/of justin ave|w/of midland a|w/of penn ave|w/of midland av|w/of rose ave|w/of bancroft	T	179
S RAILROAD AVE		P	4
S Railroad St	w/of e tenafly|s/of midland av	T	51
S Service Road	w/of s drum st|w/of amboy rd|e/of s drum st|e/of station a	T	36
S St Austins Pl	e/of n st austi|s/of st austins|n/of davis ave|w/of bard ave|e/of bard ave|e/of davis ave|e/of st austins|e/of st austin|w/of st austins|s/of bard ave	T	54
S/S CRABTREE AVE	w/o trina lane|trina lane	P	4
S/S NICK LAPORTE PL	e/o stuyvesant pl|w/o bay st|e stuyvesant	P	9
S/S of BOUNDARY AVEN	ue 25' w/o midland a|ue 100' w/o midland|ue 20' w/o midland a	S	6
S/S of SHARROTTS ROA	d 75' e/o veterans r|d 25' w/o veterans r|d 50' e/o veterans r	S	5
S/S of VETERANS ROAD	west 500' w/o rossv|west 50' w/o arthur|west 100' w/o herve|east 10' e/o poplar|east 300' e/o bloom|west 100' e/o arthu|west 50' e/o arthur|west 200' n/o arthu	S	11
Sable Ave	s/of elbe ave|e/of weser ave|e/of mosel ave	T	5
SAINT MARKS PL		P	5
SAINT MARKS PLACE		P	4
Sampson Ave		T	16
Samuel Pl	n/of forest av|n/of forest ave|e/of forest av	T	11
SAND LANE		P|S	20
Sand Ln	s/of mcclean av|s/of macfarland|e/of bay st|e/of victory bl|e/of macfarland	T	231
Sandalwood Dr	w/of redwood av	T	70
SANDALWOOD DR		P	9
SANDALWOOD DRIVE		P	6
Sandborn St		T	5
Sandgap St	s/of arden ave	T	12
SANDGAP STREET		S	11
Sandra Ln		T	4
Sands St	s/of van duzer|w/of van duzer|e/of bay st|n/of bay st|w/of van duzer s|w/of bay st|e/of van duzer|s/of bay st|e/of van duzer s	T	110
Sanford Pl	e/of fairview a	T	58
Sanilac St		T	9
SANTA MONICA LN		P	5
Saunder St	w/of britton av|e/of oder ave	T	13
Savin Ct		T	9
Sawyer Ave		T	7
Saxon Ave	e/of ferndale av|e/of ferndale|s/of ferndale|w/of steinway a|n/of gadsen pl|e/of richmond a|w/of steinway av|w/of merrymount|n/of ferndale a|w/of merrymoun|s/of ferndale a|w/of gadsen pl|w/of ferndale a|w/of ferndale|s/of gadsen pl|e/of gadsen pl|e/of ferndale a|n/of ferndale c|w/of ferndale av|s/of ferndale ct|w/of ferndale c|s/of richmond|e/of steinway a	T	116
Saybrook St		T	11
Scarboro Ave	e/of bay st|s/of bay st|n/of bay st|e/of abbott st|w/of new ln|w/of bay st	T	152
SCARBORO AVE	abbott st	P	15
SCARBORO AVENUE		P	4
Scarsdale St	e/of school st|e/of seeley ln|e/of lindenwood	T	20
SCHMIDTS LANE		P	4
Schmidts Ln	s/of todt hill|w/of slosson ave|e/of manor rd|w/of manor rd|s/of manor rd|w/of laguardia	T	118
Schoharie St	w/of seneca ave	T	7
SCHOOL RD	dennis torricelli st	P	37
School Rd	s/of bay st|n/of bay st|e/of lily pond|w/of dennis to	T	34
SCHOOL ROAD		S|P	31
School St	e/of scarsdale|s/of scarsdale|w/of lindenwood|s/of lindenwood|w/of scarsdale	T	13
Schubert St	s/of st johns av	T	4
Schuyler St	w/of richmond t|s/of richmond te|e/of stuyvesant|s/of richmond t|w/of richmond te	T	26
SCOTT AVE		P	5
Scott Ave		T	41
Scranton Ave	e/of pompey ave|w/of wainwright|e/of wainwright|w/of richmond a	T	59
Scranton St		T	7
SCRIBNER AVE		P	10
Scribner Ave	w/of westervelt|n/of westervelt|s/of westervelt|e/of westervelt	T	171
Seacrest Ave		T	35
Seafoam St		T	5
SEAFOAM STREET		S	5
SEAVER AVE		P	7
Seaver Ave	n/of richmond rd|e/of jefferson|s/of richmond|s/of hylan blvd|e/of richmond rd|n/of richmond r|s/of richmond rd|s/of richmond r|e/of richmond r|e/of husson st	T	221
Seaview Ave	s/of olympia bl|n/of quincy ave|e/of olympia bl|e/of mason ave|n/of mason ave|n/of olympia bl|s/of nugent ave|n/of patterson|s/of olympia blv|w/of quincy ave|s/of hylan blvd|n/of nugent av|n/of hylan blvd|n/of olympia b|w/of nugent ave|w/of patterson a|e/of nugent av|s/of mason ave|w/of nugent av|e/of olympia b|s/of patterson|e/of nugent ave|w/of olympia blv|s/of patterson a|s/of nugent av|n/of liberty av|n/of olympia blv|w/of olympia bl|n/of patterson a|s/of olympia b|e/of hylan blvd|n/of father ca	T	6219
SEAVIEW AVE	quincy ave|oceanside ave	P	87
SEAVIEW AVENUE	i/o quincy ave	S|P	120
Seguine Ave	n/of kingsland|n/of hylan blvd|s/of melville s	T	65
SEGUINE AVE		P	5
Seguine Pl		T	11
Seidman Ave		T	34
Seldin Ave	s/of lamberts ln|s/of lamberts l|n/of roman ave|e/of lamberts ln	T	38
Selkirk St		T	12
Seneca Ave	s/of victory bl|n/of little clo|e/of little clov|n/of little clov	T	52
Seneca St		T	13
Serrell Ave		T	49
Seth Ct		T	11
Seward Pl		T	9
Seymour Ave		T	20
Shadow Ln	w/of e broadwa	T	11
Shafter Ave	n/of katan ave|w/of katan ave|n/of dewey ave	T	18
Shale St	e/of leason pl	T	42
Sharon Ave	s/of forest ave|e/of forest ave|n/of forest ave|w/of forest ave	T	131
Sharpe Ave	w/of charles av|s/of harrison av|e/of harrison|s/of castleton|e/of harrison a|s/of charles av|n/of harrison a|n/of castleton|s/of harrison|s/of charles ave|e/of harrison av|s/of harrison a|w/of post ave|w/of harrison a|n/of charles av|e/of castleton	T	222
SHARPE AVE		P	33
Sharrett Pl	n/of cortlandt|e/of lexington	T	8
Sharrott Ave	n/of sherwood a|s/of penton st	T	15
Sharrotts Rd	w/of veterans r|n/of veterans r|n/of veterans|s/of veterans|w/of arthur kil|e/of veterans r|w/of veterans|e/of veterans|s/of veterans r|w/of penton st|s/of darnell ln	T	178
SHARROTTS RD		P	6
Shaughnessy Ln	s/of tompkins av|e/of white plai|s/of tompkins a|w/of tompkins a	T	51
Sheffield St	s/of delafield	T	46
Sheldon Ave	s/of carlton bl|s/of foster rd|n/of arden ave|e/of carlton bl|s/of huguenot a	T	186
SHELDON AVE		P	4
SHELLEY AVE		P	4
Shelly Ave	e/of victory blv|e/of victory bl	T	29
Shenandoah Ave	n/of latimer av|w/of latimer av	T	35
Shepard Ave	w/of travis ave	T	29
Sheraden Ave	e/of willowbroo|w/of willowbroo|n/of willowbroo|s/of victory blv|s/of victory bl|n/of victory bl|e/of victory blv|e/of victory bl	T	71
Sheridan Ave	n/of w fingerbo|e/of crist st|w/of crist st|n/of crist st	T	33
Sheridan Ct	n/of hopkins av|w/of hopkins av|e/of hopkins av|e/of hopkins a	T	25
Sherman Ave	n/of fort pl|e/of benziger a|w/of benziger a|e/of fort pl|s/of fort pl|w/of hendricks|n/of benziger av	T	119
Shiel Ave		T	55
SHIEL AVE		P	8
Shift Pl		T	22
Shiloh St	w/of steinway a|w/of merrymoun|w/of merrymount|e/of steinway av	T	47
Shirley Ave	e/of barclay av|e/of hales ave|w/of richmond av|w/of richmond a|n/of hales ave|w/of hales ave	T	47
Shirra Ave		T	8
Shore Rd	e/of satterlee|n/of finlay st	T	9
Shotwell Ave		T	43
SHOTWELL AVE		P	4
Sideview Ave		T	16
Signal Hill Rd	e/of howard av|w/of howard ave|e/of arlo rd|s/of howard ave|e/of howard ave|n/of howard ave	T	39
Signs Rd	e/of victory b|e/of spark pl|n/of spark pl|e/of dinsmore s|e/of victory bl|s/of dinsmore|w/of carreau ave|s/of howard ave	T	43
Silver Lake Park Rd		T	6
Silver Lake Rd	w/of haven espl|s/of haven espl|e/of haven espl|e/of havenwood r	T	162
SIMONSON AVE		P	4
Simonson Ave	s/of richmond r|e/of richmond t|w/of richmond t|n/of walker st|n/of richmond te	T	235
Simonson Pl	s/of castleton a|n/of post ave|n/of castleton|s/of bond st|w/of dubois ave|s/of catherine	T	47
Simpson St	e/of liberty av|w/of seaview a|e/of seaview ave|w/of garretson|n/of seaview av|e/of seaview av|w/of seaview av|s/of seaview av|n/of liberty av|s/of garretson	T	44
Sinclair Ave		T	150
Slaight St	s/of mason ave|s/of treadwell a|w/of treadwell a	T	24
SLAIGHT STREET		P	4
Slater Blvd	e/of mason ave|w/of buel ave|s/of hylan blvd|s/of quincy ave|n/of hylan blvd|w/of hylan blvd|e/of olympia bl|w/of father cap	T	56
Slayton Ave		T	9
Sleepy Hollow Rd	e/of freedom ave|n/of mulberry a|e/of mulberry a|s/of mulberry a|e/of mulberry c	T	46
Sleight Ave		T	12
Slosson Ave	s/of ellsworth|e/of seaview av|n/of drake ave|n/of victory bl|n/of ellsworth p	T	30
Slosson Ter	e/of central ave|e/of central av|w/of bay st	T	353
Smith Ave	n/of utter ave|s/of utter ave	T	14
Smith Ct		T	5
Smith Pl		T	14
Smith St	s/of st marys av|n/of st marys a	T	10
Smith Ter		T	5
Smyrna Ave	w/of woehrle ave|e/of shotwell a|w/of woehrle av	T	16
Sneden Ave	e/of annadale r|w/of fabian st	T	23
Snug Harbor Rd	w/of richmond te|w/of richmond|e/of richmond|e/of richmond t	T	12
Sobel Ct	s/of targee st|s/of park hill a|w/of park hill|n/of bowen st|e/of park hill a|e/of bowen st|e/of targee st|w/of park hill a|w/of bowen st|s/of bowen st|s/of hill st|w/of fort hill p|w/of targee st	T	104
Sommer Ave	s/of speedwell a|s/of speedwell|w/of arlene st|e/of arlene st	T	58
SOMMER AVE		P	4
Sommers Ln	n/of reon ave|s/of victory bl|n/of windsor rd	T	32
Soren St	e/of rupert ave|w/of roanoke st|s/of rupert ave|e/of roanoke st|e/of oakville s|w/of rupert ave|e/of oakville st|s/of oakville st|n/of oakville s|w/of mcdonald st|n/of roanoke st|n/of oakville st|n/of rupert ave	T	38
SOUTH AVE	goethals rd|wolkoff lane|goethals rd n|arlington pl	P	42
South Ave	e/of amador st|w/of lisk ave|w/of amador st|s/of wemple st|s/of leon st|s/of wolkoff ln|s/of lisk ave|n/of amador st|s/of regal walk|n/of wolkoff ln|n/of wemple st|e/of goethals	T	211
SOUTH AVENUE		P|S	4
SOUTH BEACH	lot 5|lot 2|lot 6	P	4
South Greenleaf Ave	n/of margarett	T	7
South Railroad Ave	w/of bache ave|e/of bache ave|e/of jacques av|w/of colfax ave	T	8
South St		T	61
Spark Pl	s/of signs rd	T	9
Sparkill Ave	w/of winfield a|n/of reid ave	T	34
SPARTAN AVE		P	5
Spartan Ave	w/of yale st	T	113
Speedwell Ave	n/of sommer ave|s/of nostrand a|s/of victory bl	T	29
Sperry Pl	n/of anaconda st|w/of delmar ave|e/of anaconda st|w/of delmar av	T	21
Sprague Ave	s/of hylan blvd|w/of hylan blvd	T	68
Spratt Ave	s/of twombly ave	T	21
Spring St	w/of richmond r	T	45
Spruce St	n/of richmond|w/of richmond r|w/of mace st|n/of richmond r|e/of mace st	T	6
St Adalbert Pl	e/of morningstar	T	9
St Albans Pl	s/of amboy rd|e/of amboy rd|w/of pacific av|e/of robinson a|w/of robinson av|e/of pacific av|n/of robinson a|e/of ridgecrest|e/of pacific ave|w/of robinson a|w/of ridgecrest|n/of amboy rd	T	28
St Andrews Pl	w/of bethel ave|w/of hecker st|e/of hecker st	T	8
St Andrews Rd	w/of rockland a|s/of rockland a|n/of rockland|n/of rockland a|s/of mccully av	T	44
St Austins Pl	w/of s st aust|s/of s st aust|n/of s st austi|w/of bard ave|e/of n st austi|s/of davis ave|s/of n st austin|s/of n st austi	T	73
St George Municipal	ferry lot|si ferry lot|si courthouse lot|courthouse lot|st george ferry lot|ferry  lot|ferry terminal|ferrt lot	T	983
St George Rd		T	13
St John Ave	s/of bay st|w/of donley ave	T	23
ST JOHNS AVE	schubert st	P	7
St Johns Ave	w/of bay st|w/of deal ct|w/of rubenstein|n/of donley ave|w/of anderson a|n/of bay st|e/of donley ave|s/of bay st|e/of strauss st|e/of colton st|w/of donley ave|s/of rubenstein|w/of strauss st	T	191
St Josephs Ave	s/of innis st|w/of nicholas a|n/of innis st|w/of innis st|e/of innis st	T	68
St Julian Pl	w/of van duzer|e/of van duzer|s/of bay st|e/of van duzer s|w/of van duzer s|n/of van duzer|w/of bay st	T	14
St Marks Pl	w/of nicholas|s/of nicholas s|s/of nicholas st|w/of wall st|s/of fort pl|e/of hyatt st|s/of hamilton av|n/of westervelt|w/of westervelt|s/of nicholas av|s/of hamilton|n/of fort pl|w/of white plai|rear of 100 central|e/of hamilton av|e/of wall st|e/of hamilton a|w/of nicholas s|s/of hamilton a|n/of victory bl|s/of westervelt|s/of st peters p|w/of hamilton a|e/of westervelt|s/of westervel|w/of nicholas st	T	2476
ST MARKS PL	wall st	P	19
ST MARKS PLACE		P	7
St Marys Ave	w/of bay st|s/of bay st|n/of bay st|e/of tilson pl|w/of victory blv|s/of tompkins a|e/of white plai|w/of anderson s|e/of smith st|w/of white plai|e/of tompkins a|e/of tompkins av|n/of tompkins a|w/of tompkins a|e/of bay st|w/of vermont av|w/of tilson pl|w/of tompkins av	T	200
ST MARYS AVE		P	12
St Patricks Pl	s/of center st|s/of richmond r|n/of center st	T	7
St Pauls Ave	n/of victory bl|w/of van duzer|w/of carroll pl|n/of taxter pl|s/of victory b	T	528
ST PAULS AVE		P	11
St Peters Pl	s/of richmond t|n/of carroll pl|w/of carroll pl|n/of carroll p|e/of carroll pl|e/of richmond t	T	29
St Stephens Pl		T	16
Stack Dr		T	25
Stafford Ave	s/of nippon ave|s/of arlo rd|n/of maguire ave	T	161
STAFFORD AVE		P	6
STANLEY AVE		P	4
Stanley Ave	s/of jersey st|w/of glen ave|w/of jersey st|e/of jersey st|n/of jersey st	T	206
Stanley Cir	n/of jersey st	T	8
STANLEY CIR		P	6
Stanwich St	n/of rome ave|s/of pamela ln	T	38
Starbuck St		T	16
Starr Ave		T	7
State St	w/of castleton|s/of castleton|n/of castleton	T	60
Staten Island Blvd	w/of beebe st|w/of ocean ter|e/of beebe st	T	18
STATEN ISLAND BLVD		P	6
STATION AVE		P	10
Station Ave	w/of amboy rd|s/of amboy rd|e/of amboy rd	T	99
Stebbins Ave	e/of bard ave	T	5
Stecher St	s/of amboy rd|e/of deisius st|e/of amboy rd	T	11
Steele Ave	s/of 3rd st|n/of 3rd st|e/of richmond r	T	19
Steers St		T	15
Steinway Ave	s/of saxon ave|s/of shiloh st|s/of travis ave|n/of nome ave|e/of shiloh st	T	171
Steinway ave & Shilo	h st	S	6
Steinway Ave & Shilo	h st	S	9
STEINWAY ST		P	4
Stepney St		T	6
Sterling Ave	e/of hylan blvd	T	12
Steuben St	e/of elbe ave|e/of rhine ave|s/of elbe ave|n/of richmond r|w/of neckar ave|s/of w fingerbo|n/of beverly rd|s/of beverly rd|s/of rhine ave|w/of elbe ave|e/of neckar ave|e/of richmond r|w/of rhine ave	T	139
STEUBEN ST		P	10
Stevenson Pl	e/of sharrott a|e/of sharrott	T	6
Stewart Ave	n/of victory bl|s/of auburn av|e/of caswell av	T	53
Stieg Ave	e/of leverett a|n/of leverett a|s/of barlow ave	T	39
Stobe Ave	s/of richmond r|e/of boundary a|n/of richmond av|n/of boundary a|w/of boundary a|w/of hylan blvd|s/of hylan blv|s/of richmond|s/of hylan blvd|n/of boundary|e/of hylan blvd|w/of mason ave|e/of husson st|e/of boundary av|s/of boundary a	T	159
STOBE AVE		P	6
Stoneham St		T	19
Storer Ave	n/of richmond r	T	4
Stratford Ave	w/of howard av|e/of arlo rd|e/of howard ave|e/of howard av|w/of howard ave	T	62
Strawberry Ln	s/of mayberry pr	T	33
Stroud Ave	n/of wainwright|s/of richmond a|e/of richmond a|w/of wainwright|s/of wainwright|e/of pompey ave	T	40
Sturges St	e/of beechwood	T	20
Stuyvesant Ave		T	5
STUYVESANT PL		P	13
Stuyvesant Pl	n/of bay st	T	7
Suffolk Ave	e/of queen st	T	45
Summer St	e/of richmond a	T	6
Summerfield Pl		T	32
Summit Pl		T	5
Sumner Ave	e/of richmond a|e/of richmond av	T	28
Sumner Pl	s/of prospect a	T	33
Sunfield Ave	w/of woodrow rd	T	13
Sunnyside Ter		T	25
Sunset Ave	e/of joseph ct|w/of willowbroo|s/of harold st|n/of willowbro|w/of willowbro|w/of joseph av|s/of willowbro	T	71
SUNSET AVE		P	6
Surf Ave	w/of sprague av|s/of loretto st	T	22
Sutton Pl		T	5
Swan St	n/of st pauls av|e/of st pauls a|n/of van duzer|w/of bay st|e/of van duzer|e/of st pauls av|e/of van duzer s	T	32
Sweetbrook Rd		T	4
Sweetwater Ave	w/of nelson ave	T	20
Swinnerton St	s/of amboy rd|e/of amboy rd|w/of amboy rd|n/of amboy rd	T	60
SWINNERTON ST		P	4
Sycamore St	w/of robinson|w/of woods of a	T	45
Sydney Pl		T	15
Sylvaton Ter	w/of bay st|w/of church ln|s/of edgewater|n/of church av|w/of edgewater	T	23
Sylvia St	n/of richmond a|w/of richmond a|e/of richmond a|w/of wainwright|s/of richmond a|w/of richmond	T	152
Tabb Pl		T	33
Tacoma St	w/of providence|s/of providence	T	38
Taft Ave	w/of westervel|w/of westervelt	T	68
Talbot Pl	e/of norwood ave|s/of vanderbilt|e/of vanderbilt|s/of norwood av|n/of norwood av|w/of norwood av|e/of norwood av	T	15
Tallman St	e/of lipsett a	T	10
Tanglewood Dr	w/of willowwood	T	56
Targee St	n/of waverly pl|s/of irving pl|e/of metcalfe s|e/of dekalb st|s/of waverly p|s/of hay st|w/of venice av|e/of irving pl|n/of irving pl|n/of osgood ave|w/of osgood ave|e/of vanderbilt|n/of dekalb st|e/of metcalfe st|s/of waverly pl|s/of metcalfe s|e/of rome ave|n/of venice ave|e/of venice ave|w/of narrows rd|e/of waverly pl|s/of venice av|w/of irving pl|s/of broad st|n/of laurel ave|e/of ellington s|e/of columbia a|s/of laurel ave	T	563
TARGEE ST	laurel ave|waverly pl	P	47
TARGEE STREET		P|S	16
Tarlee Pl	e/of florence s|e/of hylan blvd|s/of florence s|s/of florence|n/of florence s	T	23
Tarring St	w/of guyon ave	T	5
Tarrytown Ave	e/of guyon ave|s/of guyon ave	T	28
Tate St	w/of trantor pl|e/of trantor pl|s/of trantor pl	T	11
Tatro St		T	10
Taunton St		T	34
Taxter Pl	e/of st pauls av|e/of st pauls a	T	10
TAYLOR CT		P	6
Taylor St	s/of cary ave|n/of delafield a|n/of cary ave|w/of richmond t|s/of castleton|n/of castleton|n/of taylor ct|n/of richmond t|w/of castleton	T	216
TAYLOR ST		P	13
Teakwood Ct		T	8
Tenafly Pl		T	12
Tennyson Dr	n/of wiman ave|s/of littlefiel|e/of seacrest a|e/of wiman ave|w/of glover st|w/of filipe ln|n/of glover st|w/of nelson av|s/of glover st|e/of nelson ave|w/of winchester|e/of harbour ct|s/of winchester|w/of wiman ave	T	159
Terrace Ave		T	7
The Blvd	w/of jewett ave|w/of clinton b|w/of wardwell av	T	19
Theresa Pl		T	55
Thollen St	w/of hopkins av|w/of spratt ave|w/of hopkins a	T	34
Thomas Pl	w/of reno ave|s/of reno ave	T	11
Thomas St	w/of bay st	T	43
Thompson St	e/of bay st|w/of bay street|e/of front st|e/of wright st|s/of bay st|w/of bay st|w/of front st|n/of bay st|n/of front st	T	135
Thornycroft Ave	n/of hylan blvd|e/of richmond a|e/of sycamore s	T	86
Thurston St	w/of woodbine av	T	8
Tillman St	e/of manor rd|w/of manor rd|s/of manor rd|w/of area pl	T	52
Tilson Pl	s/of st marys a|e/of butler pl|n/of st marys av	T	55
Tioga St	w/of clove rd|e/of oneida ave	T	28
Titus Ave		T	90
Toddy Ave	e/of signs rd|n/of gary pl	T	15
Todt Hill Rd	s/of schmidts ln|n/of tillman st|e/of schmidts|s/of victory bl	T	49
Token St		T	25
Tompkins Ave	s/of hill st|s/of vanderbilt|w/of vanderbilt|n/of maryland a|n/of hill st|n/of thelma ct|n/of garfield a|w/of tompkins st|w/of fingerboar|e/of thelma ct|e/of hill st|s/of tompkins st|n/of fingerboar|s/of vanderbil|s/of fingerboar|s/of susan ct|s/of st marys a|e/of clifton ave|e/of vanderbilt|e/of susan ct|w/of thelma ct|e/of fingerboar|w/of mcclean av|e/of duer ave	T	268
TOMPKINS AVE		P	16
Tompkins Cir	n/of fiedler av|s/of fiedler ave	T	48
Tompkins Ct		T	9
Tompkins Pl	s/of court st|w/of court st	T	7
Tompkins St	s/of quinn st|w/of brownell|w/of brownell s|s/of brownell|e/of quinn st|s/of brownell s|e/of brownell s|s/of brownell st|n/of brownell s	T	158
Topping St		T	9
TOPPING STREET		S	9
Towers Ln	e/of victory bl	T	6
Townsend Ave	w/of bay st	T	99
TOWNSEND AVE		P	5
TRANTOR PL	dixon ave	P	9
Trantor Pl	w/of forest ave|n/of dixon ave|n/of walker st|s/of dixon ave|n/of hooker pl|e/of innis st|s/of innis st|s/of walker st	T	235
TRANTOR PLACE		P|S	8
Travis Ave	e/of evans st|w/of richmond a|e/of draper pl|e/of richmond a|w/of forest hil|w/of steinway av	T	231
TRAVIS AVE	c/o denker pl	P	15
Treadwell Ave	w/of richmond t|n/of morningsta|n/of port richm|n/of castleton|n/of blackford|s/of richmond t|s/of charles ave|s/of castleton a|e/of castleton|e/of blackford|w/of clinton p|s/of hatfield pl|n/of charles av|e/of castleton a|s/of blackford|s/of hatfield p|s/of castleton|e/of hatfield p|e/of harrison av|w/of blackford|w/of castleton a|w/of castleton|s/of richmond te|n/of richmond te|s/of charles av	T	211
TREADWELL AVE	clinton ave	P	9
Tremont Ave	s/of watchogue	T	46
Trent St	w/of keegans ln	T	16
Trenton Ct	s/of memo st	T	13
TRENTON CT		P	10
Trinity Pl		T	10
Trossach Rd	w/of murray pl	T	29
Troy St	e/of daleham st|w/of daleham st	T	8
Truman St	e/of brehaut a|e/of joline ave	T	10
Trumbull Pl	s/of brighton av|w/of brighton|w/of brighton a	T	16
Tryon Ave		T	14
TRYON AVE		P	7
Tuckahoe Ave		T	7
Tudor St	e/of nahant st|s/of dewey ave|n/of dewey ave	T	22
Tulip Cir	w/of rolling hil|n/of rolling hil	T	11
Turf Rd		T	5
Turner St	n/of crabtree a|n/of crabtree|w/of woodrow rd|e/of crabtree a|e/of crabtree|s/of crabtree|w/of crabtree a	T	42
Tuttle St		T	5
Twombly Ave		T	19
Tynan St		T	35
Tyrrell St		T	5
Tysen St	n/of fillmore s	T	57
Tysens Ln	s/of manila ave|e/of manila ave|n/of amboy rd|s/of manila av|s/of roma ave|n/of primrose pl|s/of amboy rd	T	178
Union Ave	s/of forest ave|w/of richmond t|n/of forest av|e/of forest ct|n/of forest ave|w/of forest ave	T	163
UNION AVE		P	15
Union Pl	w/of beach st|e/of bay st|s/of bay st|e/of beach st|w/of bay st	T	50
University Pl		T	26
Upton St		T	14
Urbana St		T	13
Utah St		T	6
Utter Ave	w/of manor rd|w/of fairview a|e/of manor rd|s/of manor rd	T	31
Uxbridge St	e/of forest hil	T	10
Vail Ave	e/of sharrott|e/of burton ave|w/of sharrotts	T	21
Valdemar Ave	n/of foster rd|e/of foster rd	T	16
Valencia Ave		T	5
Van Allen Ave		T	17
Van Brunt St	e/of wilson st|e/of rye ave	T	29
Van Buren St	e/of franklin a|n/of franklin a|e/of clinton av|s/of franklin a|w/of clinton ave|s/of york ave	T	150
VAN BUREN ST		P	11
Van Cortlandt Ave		T	19
VAN DUZER ST		P	22
Van Duzer St	s/of st pauls|e/of swan st|n/of st julian|n/of hannah st|n/of broad st|s/of swan st|s/of baltic st|n/of st pauls a|w/of sands st|s/of victory bl|n/of victory b|s/of hannah st|s/of st pauls a|s/of st julian|e/of st pauls a|n/of victory bl|w/of young st|s/of st julian p|w/of st julian|s/of irving pl|n/of wright st|s/of bay st|w/of swan st|e/of hannah st|s/of wright st	T	806
VAN DUZER STREET		S|P	20
Van Name Ave	s/of richmond t|n/of heusden st|e/of richmond te|s/of forest ave|e/of heusden st|n/of forest ave|e/of forest av|e/of forest ave	T	272
VAN NAME AVE	forest ave|wilcox st	P	6
Van Pelt Ave	n/of forest ave|e/of forest av|s/of forest ave|n/of forest av|w/of forest ave|e/of netherland|w/of beach st	T	197
Van Riper St	e/of port richmo|w/of port richm|n/of port richm|s/of port richmo|s/of dixon ave	T	104
VAN ST		P	4
Van St	s/of port richm|s/of richmond t	T	12
Van Wyck Ave	s/of purdy pl|e/of purdy pl|w/of purdy pl	T	18
VANDERBILT	prince st|osgood ave	P	4
VANDERBILT AVE		P	33
Vanderbilt Ave	s/of irving pl|n/of errington|w/of osgood ave|e/of irving pl|n/of irving pl|e/of nunley ct|w/of irving pl|e/of roff st	T	470
Vassar St	s/of nome ave|n/of richmond hi|w/of nome ave|e/of nome ave	T	81
VASSAR ST		P	4
Vaughan St	w/of hylan blvd	T	9
Vedder Ave	e/of richmond av|w/of willowbro	T	48
Veltman Ave	s/of forest ave|n/of forest ave|e/of jewett ave	T	65
Venice Ave	n/of targee st|e/of targee st	T	17
Venus Pl		T	15
VENUS PLACE		P	6
Vera St	n/of dongan hil	T	22
Vermont Ave	s/of st marys av|n/of maryland av|w/of st marys|s/of st marys a|s/of hylan blvd|s/of tompkins|w/of virginia av|n/of st marys av|n/of maryland a|e/of maryland av|n/of hylan blvd	T	58
Vermont Ct		T	22
Vernon Ave	w/of rensselaer|s/of ramapo ave|s/of sheldon av|n/of sheldon a|s/of ramapo av|n/of sheldon av|s/of sheldon a|n/of rensselae|n/of w drumgool|w/of sinclair a|s/of darlington|w/of sheldon av|e/of roma ave|s/of carlton av|n/of rensselaer|n/of sinclair a|s/of sinclair a|w/of darlington|s/of stafford a|e/of sheldon av|n/of edgegrove a|s/of rensselae|s/of sinclair	T	92
Vespa Ave	e/of ruxton ave|n/of ruxton ave|w/of arden ave|e/of arden ave|s/of ruxton ave|n/of jefferson|w/of canton ave|e/of jefferson|e/of almond st|w/of almond st|e/of canton ave|w/of jefferson|w/of ruxton ave	T	32
Veterans Rd	s/of sharrotts|e/of e service|w/of arthur kil|e/of clay pit|w/of e service r|n/of arthur kil|w/of e service|w/of artillary|e/of huguenot|s/of bloomingd|e/of zebra pl|n/of pheasant|s/of bloomingda|w/of sharrotts|s/of kunath ave|n/of wirt ave|w/of rossville|n/of sharrott a|w/of bloomingd|e/of arthur kil|w/of arthur kill|n/of pheasant l|e/of sharrotts|n/of sharrotts|e/of arthur ki|s/of rossville|w/of arthur ki|s/of arthur ki|n/of bloomingda|s/of salamander|e/of bloomingd|s/of wirt ave|w/of wirt ave|s/of woodrow rd|e/of rossville|w/of poplar av|n/of arthur ki|e/of wirt ave|w/of clay pit|e/of salamande	T	197
VETERANS RD	east arthur kill rd	P	4
VETERANS RD E	arthur kill rd	P	15
VETERANS RD EAST	arthur kill rd	P	5
VETERANS RD W	zebra pl	P	13
VETERANS RD WEST	arthur kill rd|zebra pl|rossville ave	P	32
VETERANS ROAD WEST		S	25
Victoria Rd	w/of manchester|n/of green valle|s/of green valle|e/of green valle|w/of green valle|s/of minthorne	T	39
Victory Blvd	e/of albert st|w/of mountainvie|w/of jewett ave|e/of clermont p|w/of bay st|w/of murray hul|n/of forest av|e/of perry ave|w/of theresa p|e/of slosson av|s/of minthorne s|w/of little clo|s/of dinsmore s|s/of eddy st|w/of winthrop p|w/of wild ave|e/of raymond ave|w/of w service|s/of minthorne|w/of forest ave|w/of silver lak|w/of ontario av|w/of brenton pl|w/of carmel ave|e/of gansevoor|e/of dinsmore s|w/of beechwood a|e/of coale ave|w/of theresa pl|w/of woodstock a|w/of westcott|e/of raymond av|e/of theresa p|e/of minthorne|e/of little clo|w/of labau ave|e/of forest ave|w/of jersey st|n/of seneca ave|n/of byrne ave|n/of forest ave|w/of watchogue|w/of raymond av|e/of murray hul|n/of bay st|s/of silver la|s/of bay st|w/of dinsmore s|s/of west shore|s/of forest av|e/of bay st|n/of minthorne s|w/of forest av|n/of silver la|e/of minthorne s|s/of theresa p|s/of silver lak|w/of amity pl|e/of theresa pl|w/of sommers ln|e/of byrne ave|e/of brenton pl|e/of jewett ave|s/of simmons ln|w/of minthorne|n/of minthorne|n/of theresa p|e/of jersey st|e/of forest av|s/of royal oak|s/of seneca ave|e/of eddy st|s/of forest ave|s/of w service|w/of royal oak r|e/of westcott b|w/of westcott bl|w/of seneca ave|w/of raymond ave|e/of s greenlea|w/of dinsmore|e/of ontario av|n/of other-see c|s/of raymond p	T	5447
VICTORY BLVD	dinsmore st	P	62
VICTORY BOULEVARD		S	32
Villa Ave	n/of port richmo|s/of port richm|s/of walker st|w/of port richmo|s/of dixon ave|w/of walker st|n/of walker st|e/of dixon ave|e/of port richm	T	124
Villanova St	e/of rockne st	T	20
Vincent Ave		T	12
Vine St	w/of belmont pl|s/of daniel low|w/of daniel low|e/of daniel low|e/of belmont pl|s/of belmont pl	T	15
Vineland Ave	e/of nippon ave|w/of nippon av|n/of carlton av|e/of grantwood a	T	148
Virginia Ave	s/of bay st|e/of bay st|w/of vermont ave|e/of tompkins a|e/of fox hill t|w/of tompkins av|w/of tompkins a|w/of bay st|w/of fletcher s|w/of anderson s	T	205
VIRGINIA AVENUE		S	4
Virginia Pl		T	5
Vista Ave	e/of richmond r	T	12
Von Braun Ave	e/of alexander	T	6
Vreeland St	e/of port richm|e/of heberton a|w/of heberton a|s/of park ave|w/of port richmo|e/of port richmo|w/of heberton|w/of park ave	T	88
Vulcan St	e/of olympia blv|n/of olympia blv|e/of olympia bl|s/of olympia bl	T	45
W Buchanan St	e/of lafayette	T	15
W Castor Pl		T	4
W Caswell Ave	s/of richmond a|e/of farraday s	T	46
W Cedarview Ave		T	65
W Drumgoole Rd	s/of dorval ave|n/of huguenot a|e/of notus ave|s/of notus ave|s/of smyrna ave|n/of notus ave|n/of dorval ave	T	52
W FINGERBOARD RD		P	4
W Fingerboard Rd	s/of tacoma st|w/of windermere	T	95
W RALEIGH AVE		P	4
W Raleigh Ave		T	7
W SERVICE RD		P	5
W Service Road	n/of wild ave|s/of victory bl	T	207
W/S of FAIRBANKS AVE	nue 20' s/o grayson|nue 35' n/o grayson|nue 25' s/o grayson	S	5
W/S of FRONT STREET	500' n/o wave street|300' n/o wave street|200' n/o wave street|20' n/o canal street	S	10
W/S of GREENFIELD AV	enue 5' w/o burgundy|enue 0' e/o burgundy|enue 40' s/o burgund|enue 20' w/o burgund|enue 0' s/o burgundy|enue 20' e/o burgund|enue 25' s/o burgund|enue 25' n/o burgund|enue 5' s/o burgundy|enue 10' e/o burgund|enue 0' w/o burgundy|enue 20' s/o burgund|enue 50' s/o burgund|enue 60' s/o osgood|enue 10' w/o burgund|enue 25' w/o burgund	S	53
W/S of VETERANS ROAD	west 50' n/o arthur|west 200' s/o arthu|west 500' n/o rossv|west 300' s/o arthu|west 400' s/o arthu|west 100' s/o arthu|west 900' n/o rossv	S	8
W/S of WATER STREET	50' s/o navy pier co|60' n/o navy pier co|250' s/o navy pier c|200' s/o navy pier c|275' n/o navy pier c|30' n/o navy pier co|50' n/o navy pier co|20' n/o navy pier co|225' n/o navy pier c|230' n/o navy pier c|250' n/o navy pier c|75' n/o navy pier co|100' n/o navy pier c|150' s/o navy pier c|100' s/o navy pier c|50' s/o front street|75' s/o front street|30' s/o navy pier co	S	31
Wade St		T	5
Wadsworth Ave	w/of tompkins a|s/of tompkins a	T	94
WADSWORTH AVE		P	24
Wagner College Campu	e/of howard ave|s/of howard ave	T	4
Waimer Pl	n/of amboy rd|s/of mosely ave	T	8
Wainwright Ave	n/of laredo ave|n/of figurea ave|s/of brandis ave|w/of katan ave|s/of petrus ave|e/of reading a|s/of reading av|w/of figurea ave|e/of reading av|n/of e perkiome|n/of leverett|s/of brandis a|n/of figurea av|s/of barlow ave|w/of perkiomen|e/of perkiomen|s/of perkiomen|e/of perkiomen a|n/of memphis a|s/of laredo ave|s/of katan ave|n/of reading av|e/of augusta av|s/of brandis av|s/of macon ave|e/of memphis av	T	369
Wakefield Ave		T	8
Walbrooke Ave	s/of forest ave|e/of forest ave|w/of forest ave|s/of castleton|n/of forest ave|e/of castleton	T	74
Walch Pl	e/of melville s|n/of wilbur st|e/of melville st|s/of melville s	T	37
Walcott Ave		T	23
Walden Ave		T	10
Waldo Pl	s/of laguardia a	T	8
Waldron Ave		T	17
Walker Ct	e/of ludlow st|s/of ludlow st	T	9
Walker Pl	n/of sinclair a|w/of woodrow rd	T	7
Walker St	s/of van pelt a|w/of van pelt a|w/of trantor p|e/of trantor pl|e/of morningst|e/of simonson a|w/of port richm|e/of villa ave|e/of van name a|e/of van pelt a|w/of villa ave|e/of morningsta|s/of simonson a|w/of simonson av	T	93
Wall St	s/of st marks p|w/of st marks p|s/of st marks pl|e/of belmont pl|s/of belmont pl|e/of st marks p|w/of belmont pl|s/of st marks|n/of belmont pl|n/of st marks pl|w/of st marks|e/of belmont p|n/of st marks p|e/of st marks pl	T	53
WALL ST	academy|stuyvesant pl|academy pl	P	13
Wallace Ave	n/of mcclean av|e/of mcclean ave|w/of macfarland|e/of major ave|n/of major ave|s/of mcclean av|n/of macfarland|w/of major ave|s/of macfarland|s/of major ave|w/of mcclean ave|w/of mcclean av	T	50
Walloon St	w/of maple pky	T	41
Walnut Ave	e/of hylan blvd	T	26
Walnut St		T	10
Walters Ave		T	15
Ward Ave	e/of bayview p|w/of austin pl	T	90
Wardwell Ave	w/of maine ave|s/of the blvd|n/of victory bl	T	26
Waring Ave	e/of shotwell av	T	7
WARREN ST		P	16
Warren St	w/of gordon st|n/of hill st|s/of hill st|s/of gordon st|s/of broad st|n/of laurel ave|n/of gordon st|e/of gordon st|w/of hill st	T	426
Warwick Ave		T	52
Washington Ave	n/of harold st|s/of rupert ave|s/of harold st|n/of rupert ave|e/of rupert ave	T	33
WASHINGTON AVE		P	10
Washington Pl	e/of post ave|n/of post ave|s/of albion pl|s/of post ave	T	40
Watchogue Rd	e/of demorest a|w/of bradley av|w/of jewett ave|w/of victory bl|e/of jewett ave|e/of treetz pl|w/of treetz pl	T	122
Water St	n/of bay st|e/of bay st|e/of murray hul|w/of bay st|e/of front st|w/of wright st|n/of front st|w/of front st|w/of beach st|s/of front st|e/of beach st|n/of beach st|s/of canal st|w/of broad st	T	453
WATER ST		P	4
Waterbury Ave	w/of seguine a|s/of seguine av|s/of bayview av	T	50
Waters Ave	e/of deems ave|e/of crystal av|e/of neal dow a|e/of st john av|w/of woolley av|w/of neal dow a|e/of clinton b|e/of bidwell av	T	35
Waterside Pky		T	5
Waterside St		T	4
WATERSIDE STREET		S	4
Watkins Ave		T	13
Watson Ave		T	19
Wave St	e/of bay st|e/of front st|w/of front st|w/of bay st|n/of front st|s/of front st	T	158
Wavecrest St	s/of cedar grov	T	4
Waverly Pl	w/of targee st|s/of wiederer p|e/of targee st|s/of targee st|e/of wiederer p	T	68
Wayne Pl	w/of chappell s	T	4
Wayne St	s/of broadway|e/of broadway	T	85
Weaver St		T	4
Webster Ave	e/of castleton a|e/of stanley av|w/of stanley av|s/of stanley av	T	28
WEBSTER AVE		P	7
WEED AVE		P	4
Weed Ave	w/of ebbitts st	T	121
Weiner St	s/of boscombe a|e/of boscombe a	T	11
Wellbrook Ave	e/of westwood a|s/of westwood a|w/of westwood a|n/of holden blv|s/of holden blvd|n/of westwood a|e/of portage ave	T	129
WELLBROOK AVE		P	5
Welles Ct		T	4
WELLINGTON COURT		P	5
Wellington Ct	s/of venus ln|w/of richmond h|s/of richmond h	T	259
WELLINGTON CT		P	28
Wemple St	w/of mersereau a|s/of amity pl|s/of mersereau|n/of mersereau|e/of amity pl|w/of spartan av|e/of mersereau|w/of mersereau|e/of south ave|w/of amity pl|n/of amity pl	T	70
Wenlock St	e/of lake ave|e/of simonson a|s/of lake ave|w/of morningsta|e/of simonson|n/of lake ave|s/of simonson a|n/of simonson a|w/of lake ave	T	45
Wentworth Ave	s/of olympia b	T	24
Weser Ave	w/of steuben st|e/of clove rd|n/of clove rd|s/of steuben st|s/of clove rd|e/of steuben s|n/of steuben st|e/of steuben st|n/of steuben s|w/of clove rd	T	91
WESER AVE		P	13
West Fingerboard Rd		T	5
WEST FINGERBOARD RD		P	4
WEST SERVICE RD		P	10
West St	n/of cary ave|s/of cary ave	T	112
West Ter		T	6
Westbrook Ave	n/of morningstar|s/of morningsta|w/of morningsta|w/of morningstar|n/of morningsta	T	32
Westbury Ave		T	6
WESTCOTT BLVD		P	5
Westcott Blvd	s/of coale ave|e/of victory b|w/of victory bl|n/of coale ave|n/of victory blv|e/of victory bl|n/of victory bl|s/of victory bl|n/of victory b|s/of forest ave|s/of chandler av	T	214
WESTERVELT AVE		P	9
Westervelt Ave	e/of hamilton|e/of benziger a|e/of bay st|n/of richmond te|e/of hamilton a|w/of richmond|w/of richmond t|w/of richmond te|n/of hendricks|s/of hendricks|s/of richmond t|e/of richmond t|w/of hendricks|w/of benziger a|e/of hendricks|s/of richmond|s/of layton ave|s/of st marks p|w/of victory blv|n/of hamilton a|s/of cleveland s	T	437
Westfield Ave	s/of bloomingda|e/of bloomingda	T	13
Westport St	n/of westport|s/of westport l|e/of westport|e/of westport ln|w/of essex dr|n/of essex dr|w/of westport ln|s/of essex dr|n/of westport l|e/of westport l|w/of westport l|w/of westport	T	75
Westwood Ave	w/of elvin st|w/of laguardia|e/of laguardia|e/of mountainvi|e/of sheraden a|e/of martin ave|e/of gower st|w/of martin ave|n/of mountainvi|w/of melba st|s/of fanning st|e/of wellbrook a|e/of sheraden av|w/of manor rd|w/of wellbrook|w/of roosevelt|e/of woolley av|w/of warwick av|w/of roosevelt a|e/of woolley a|w/of woolley ave|s/of martin ave|s/of elvin st|e/of bradley av|e/of bradley a|e/of roosevelt a|w/of fanning st|e/of manor rd	T	294
Wheeler Ave	e/of westwood a|s/of victory bl|n/of victory bl|s/of victory b	T	96
WHEELER AVE		P	4
Wheeling Ave		T	10
Whitaker Pl	s/of richmond r|s/of victory bl	T	55
White Pl	s/of dongan st|e/of clove rd|w/of dongan st|e/of dongan st	T	45
White Plains Ave	n/of st marys a|s/of st marys a|e/of st marys a	T	16
White St		T	12
Whitehall St		T	8
Whitewood Ave		T	7
Whitman Ave	n/of hylan blvd|s/of hylan blvd	T	22
Whitney Ave	s/of parkinson a	T	7
Wiederer Pl	n/of waverly pl|n/of prince st|n/of osgood ave|e/of prince st|e/of osgood ave|w/of waverly pl|s/of osgood ave|s/of waverly pl|s/of prince st	T	65
Wieland Ave	s/of foster rd	T	37
Wilbur Pl	w/of livermore|w/of livermore a|e/of woolley av|w/of woolley ave	T	15
Wilbur St		T	24
Wilcox St	w/of heather ct|s/of heaney ave|e/of summerfiel|w/of eleanor pl|e/of francesca|e/of van name a|w/of van name a|e/of eleanor pl|s/of van name|e/of summerfie|n/of heaney ave|e/of claudia ct	T	88
WILCOX STREET		P|S	4
WILD AVE		P	4
Wild Ave	s/of victory bl|w/of w service|e/of victory bl|w/of melvin ave|w/of victory bl|w/of s service|n/of pearson s|s/of melvin ave|s/of victory b|s/of victory blv|n/of w service|n/of victory bl	T	277
Wilder Ave	e/of wolverine|n/of center st|w/of center st|s/of morton st|s/of wolverine|e/of center st|e/of morton st|n/of wolverine	T	33
Wildwood Ln	n/of sandalwood	T	4
Wiley Pl	w/of park st|e/of park st|e/of tysens ln|w/of tysens ln|s/of tysens ln	T	30
Willard Ave		T	27
William Ave	s/of fiedler av	T	15
William St	n/of bay st|w/of bay st	T	46
Willis Ave	e/of fiedler av|s/of fiedler av|w/of fiedler av|n/of fiedler av|w/of fiedler a	T	67
Willow Ave		T	4
Willow Rd	e/of sumner ave	T	13
Willow Rd E	s/of watchogue	T	26
Willow Rd W	s/of forest ave|s/of st albans|n/of dixon ave|w/of bowles ave|s/of bowles ave|n/of vedder ave|s/of st adalber|s/of forest av|s/of dixon ave|w/of w caswell|e/of dixon ave|n/of bowles ave	T	104
Willowbrook Ct		T	19
WILLOWBROOK RD		P	5
Willowbrook Rd	n/of roosevelt a|s/of watchogue|s/of houston st|w/of roosevelt|e/of birchard a|n/of birchard a	T	180
Willowwood Ln	s/of sandalwoo|s/of sandalwood	T	19
Wilson Ave	e/of cortelyou|s/of cortelyou a|e/of richmond a|w/of richmond av|n/of richmond a|e/of eltingville|e/of richmond av|e/of richmond|w/of richmond a|n/of cortelyou a|w/of cortelyou|w/of brower ct|w/of cortelyou a	T	290
WILSON AVE		P	21
Wilson St		T	30
Wilson Ter		T	13
Wiman Ave	s/of hylan blvd|n/of hylan blvd|w/of driggs st|n/of hylan blv|e/of driggs st|w/of hylan blvd|s/of hillcrest|e/of hylan blvd	T	102
Wiman Pl		T	12
Winans St	s/of richmond te	T	15
Winant Ave	e/of charleston|s/of kramer ave|s/of wirt ave|n/of shiel ave|n/of wirt ave|e/of wirt ave|s/of radigan av|w/of radigan av|n/of charlesto|n/of lucille av|s/of shiel ave|w/of lucille av|w/of lucille ave|s/of charlesto|s/of mason blvd|e/of lucille av|s/of charleston|e/of chesterton|s/of mcbaine av|e/of mason blv|w/of shiel ave|n/of kramer ave|s/of lucille av|e/of shiel ave|n/of mason blvd	T	129
WINANT AVE		P	5
Winant Pl	e/of kreischer	T	27
Winant St	s/of charleston|w/of richmond|s/of lasalle st|w/of radigan av	T	75
Winchester Ave		T	41
Windemere Ave		T	25
Windermere Rd	e/of hylan blvd|n/of steuben s|w/of steuben st|e/of steuben st|w/of pouch ter|n/of steuben st	T	49
Windham Loop	e/of marsh ave|s/of marsh ave|e/of kathy pl|e/of kathy ct	T	149
WINDHAM LOOP		P	5
Windom Ave		T	5
Windsor Rd	w/of slosson av|w/of todt hill|n/of victory bl|w/of todt hill r|e/of todt hill r|e/of little clo	T	95
Winfield Ave	e/of parkinson|s/of parkinson|w/of parkinson|s/of parkinson a|n/of parkinson|e/of parkinson a|w/of parkinson a|n/of parkinson a	T	49
Winfield St		T	34
Wingham St		T	29
Winham Ave		T	95
Winston St		T	9
Winter Ave	w/of jersey st|s/of westervelt|e/of jersey st|e/of westervelt|w/of westervelt|n/of westervelt|n/of jersey st	T	76
WINTER AVE		P	4
Winthrop Pl	n/of victory b|w/of victory b|s/of victory blv|e/of victory bl|n/of victory bl|s/of victory bl|n/of victory blv|s/of dongan ave|w/of victory bl|e/of dongan ave|n/of windsor rd	T	576
Wirt Ave		T	69
WIRT AVE	i/o winant ave	P	5
Witteman Pl	e/of ocean ter|s/of milford dr	T	16
Woehrle Ave	e/of woodrow rd|n/of woodrow rd|s/of woodrow rd	T	67
WOEHRLE AVE		P	17
Wolcott Ave	e/of e drumgool	T	12
Wolverine St	n/of amboy rd	T	55
Wood Ave	n/of amboy rd|w/of amboy rd|s/of amboy rd|e/of amboy rd	T	55
WOOD AVE		P	6
Woodbine Ave	s/of watchogue|s/of thurston st	T	48
Woodcrest Rd	s/of albert ct	T	50
Woodland Ave		T	35
Woodlawn Ave	n/of hylan blvd|w/of winfield a|n/of clove rd|s/of winfield a|e/of hylan blvd	T	21
Woodrow Rd	e/of winant ave|n/of arthur kil|e/of woehrle av|n/of woehrle av|s/of row pl|s/of benson st|e/of arthur kil|s/of alexander|e/of heffernan|e/of powell st|s/of susanna ln|s/of bloomingd|e/of vineland|n/of evan pl|e/of gladwin a|e/of berry ave|e/of foster rd|e/of walker pl|n/of hinton st|n/of oak ln|n/of erika loop|s/of foster rd|w/of veterans r|n/of benson st|s/of arthur kil|w/of bloomingda|s/of chatham st|s/of winston st|w/of arthur kil|s/of winant ave|s/of tynan st|n/of woehrle a|w/of erika loop|s/of erika loop|e/of benson st|w/of carlton b|n/of winston st|w/of vineland a|w/of benson st|s/of woehrle av|s/of nippon ave	T	284
WOODROW RD	veterans rd e|woehrle	P	13
WOODROW ROAD		S|P	12
Woods of Arden Rd	n/of king st	T	36
Woodstock Ave	e/of victory bl|n/of oxford pl	T	23
Woodvale Ave	s/of georges ln|w/of hylan blv|s/of ficarelle|s/of hylan blv	T	25
Woodward Ave	w/of s gannon a|e/of s gannon a|n/of westwood|s/of s gannon a|n/of s gannon a|s/of s gannon|e/of gannon ave	T	78
Woolley Ave	s/of victory bl|n/of victory bl|w/of ruth st|s/of gurdon st	T	90
Wrenn St		T	8
Wright Ave	e/of richmond t	T	76
Wright St	e/of canal st|n/of broad st|w/of canal st|e/of water st|s/of canal st|s/of van duzer|w/of water st|w/of broad st	T	288
Wygant Pl	e/of jewett ave	T	11
Wyona Ave	e/of hawthorne|w/of hawthorne|w/of chappell s|s/of victory bl	T	19
Xenia St	s/of hurlbert s	T	11
Yale St	s/of spartan ave|n/of birch rd|e/of spartan av|w/of spartan ave|e/of spartan ave	T	27
Yetman Ave	w/of arthur kil|s/of academy ave|s/of arthur kil|e/of arthur kil|e/of clearmont	T	116
York Ave	e/of richmond t|e/of richmond te|s/of richmond t|s/of arnold st|n/of jersey st	T	213
YORK AVE		P	7
York Ter	s/of fillmore	T	8
Young St	w/of targee st|s/of targee st|n/of van duzer s	T	49
Yucca Dr	n/of dogwood dr|s/of dogwood dr|w/of dogwood dr	T	16
YUKON AVE		P	7
YUKON AVENUE		P	4
Zeck Ct		T	5
Zoe St	e/of seaver ave|e/of stobe ave	T	165
Zwicky Ave		T	6
